TH;CODMUN;AMBITO;DISTRITO;SECCION;MESA;CENSO;VOTANTES;NULOS;VALIDOS;BLANCOS;VOTOS_CANDIDATOS;ABSTENCIONES;EAJ-PNV;PP;HB;U.AL.;EA;EB;PSE-EE/PSOE;CNPS
ARABA-?LAVA;1;ALEGR?A-DULANTZI;1;1;U;793;516;4;512;14;498;277;195;56;26;52;62;21;86;0
ARABA-?LAVA;2;AMURRIO;1;1;A;336;216;4;212;6;206;120;78;26;41;11;40;5;5;0
ARABA-?LAVA;2;AMURRIO;1;1;B;1254;864;7;857;14;843;390;230;155;114;45;162;61;73;3
ARABA-?LAVA;2;AMURRIO;1;2;A;245;164;1;163;2;161;81;72;12;36;10;26;5;0;0
ARABA-?LAVA;2;AMURRIO;1;2;B;533;345;0;345;10;335;188;91;29;51;19;77;14;53;1
ARABA-?LAVA;2;AMURRIO;1;2;C;530;339;1;338;5;333;191;123;37;37;27;47;20;42;0
ARABA-?LAVA;2;AMURRIO;1;2;D;212;128;0;128;1;127;84;39;22;37;2;25;1;1;0
ARABA-?LAVA;2;AMURRIO;1;3;U;777;547;6;541;6;535;230;171;76;61;24;105;30;68;0
ARABA-?LAVA;2;AMURRIO;1;4;U;1099;707;5;702;11;691;392;220;73;91;28;130;32;115;2
ARABA-?LAVA;2;AMURRIO;1;5;U;1038;655;11;644;13;631;383;163;62;76;35;125;44;124;2
ARABA-?LAVA;2;AMURRIO;1;6;U;765;486;9;477;7;470;279;142;39;84;20;91;20;72;2
ARABA-?LAVA;2;AMURRIO;1;7;U;917;620;15;605;8;597;297;167;52;77;32;112;34;123;0
ARABA-?LAVA;3;ARAMAIO;1;1;A;735;530;5;525;10;515;205;141;8;149;3;199;3;12;0
ARABA-?LAVA;3;ARAMAIO;1;1;B;368;264;3;261;1;260;104;87;3;64;5;92;2;7;0
ARABA-?LAVA;4;ARTZINIEGA;1;1;U;1030;756;9;747;16;731;274;280;159;111;30;59;36;54;2
ARABA-?LAVA;6;ARMI??N;1;1;U;116;82;0;82;4;78;34;20;32;1;19;0;3;3;0
ARABA-?LAVA;8;ARRAZUA-UBARRUNDIA;1;1;U;573;339;3;336;4;332;234;130;38;31;60;16;13;44;0
ARABA-?LAVA;9;ASPARRENA;1;1;A;573;344;2;342;8;334;229;108;25;67;32;57;9;36;0
ARABA-?LAVA;9;ASPARRENA;1;1;B;705;440;5;435;6;429;265;141;36;93;41;52;13;51;2
ARABA-?LAVA;10;AYALA / AIARA;1;1;A;812;574;4;570;5;565;238;253;129;54;27;59;29;11;3
ARABA-?LAVA;10;AYALA / AIARA;1;1;B;433;273;5;268;4;264;160;82;48;40;13;48;14;19;0
ARABA-?LAVA;10;AYALA / AIARA;1;1;C;490;368;7;361;1;360;122;205;58;30;11;38;5;13;0
ARABA-?LAVA;11;BA?OS DE EBRO / MA?UETA;1;1;U;294;210;3;207;7;200;84;98;42;4;34;2;2;18;0
ARABA-?LAVA;13;BARRUNDIA;1;1;U;489;254;1;253;1;252;235;104;24;31;44;27;12;9;1
ARABA-?LAVA;14;BERANTEVILLA;1;1;U;344;234;1;233;6;227;110;93;35;10;56;5;17;11;0
ARABA-?LAVA;16;BERNEDO;1;1;U;500;252;0;252;2;250;248;107;62;19;40;4;8;10;0
ARABA-?LAVA;17;CAMPEZO / KANPEZU;1;1;U;972;632;3;629;13;616;340;258;122;46;71;39;14;65;1
ARABA-?LAVA;18;ZIGOITIA;1;1;U;778;456;6;450;4;446;322;126;44;101;62;56;36;21;0
ARABA-?LAVA;19;KRIPAN;1;1;U;174;116;0;116;0;116;58;87;15;3;0;4;4;3;0
ARABA-?LAVA;20;KUARTANGO;1;1;U;322;189;1;188;1;187;133;86;14;48;23;2;7;7;0
ARABA-?LAVA;21;ELBURGO / BURGELU;1;1;U;178;101;0;101;0;101;77;36;14;7;28;5;6;5;0
ARABA-?LAVA;22;ELCIEGO;1;1;U;782;568;7;561;6;555;214;92;136;13;62;48;37;166;1
ARABA-?LAVA;23;ELVILLAR / BILAR;1;1;U;307;207;0;207;3;204;100;106;20;10;48;2;5;13;0
ARABA-?LAVA;27;IRURAIZ-GAUNA;1;1;U;353;191;2;189;3;186;162;52;42;26;45;9;11;1;0
ARABA-?LAVA;28;LABASTIDA / BASTIDA;1;1;U;811;541;0;541;4;537;270;107;116;102;82;10;41;78;1
ARABA-?LAVA;30;LAGR?N;1;1;U;177;123;1;122;1;121;54;61;18;0;23;3;6;10;0
ARABA-?LAVA;31;LAGUARDIA;1;1;A;534;371;1;370;2;368;163;117;125;15;30;26;15;40;0
ARABA-?LAVA;31;LAGUARDIA;1;1;B;636;438;8;430;3;427;198;139;153;17;39;21;7;49;2
ARABA-?LAVA;32;LANCIEGO / LANTZIEGO;1;1;U;535;360;2;358;1;357;175;159;62;16;46;0;4;70;0
ARABA-?LAVA;33;LAPUEBLA DE LABARCA;1;1;U;674;541;3;538;3;535;133;305;107;8;31;24;16;42;2
ARABA-?LAVA;34;LEZA;1;1;U;174;109;1;108;1;107;65;31;15;8;6;25;2;20;0
ARABA-?LAVA;36;LAUDIO / LLODIO;1;1;A;809;524;7;517;10;507;285;174;102;58;24;76;17;55;1
ARABA-?LAVA;36;LAUDIO / LLODIO;1;1;B;947;626;4;622;5;617;321;178;114;88;33;82;43;78;1
ARABA-?LAVA;36;LAUDIO / LLODIO;1;2;A;799;485;5;480;7;473;314;120;59;81;38;28;59;87;1
ARABA-?LAVA;36;LAUDIO / LLODIO;1;2;B;882;542;5;537;7;530;340;148;80;79;29;28;47;119;0
ARABA-?LAVA;36;LAUDIO / LLODIO;1;3;A;568;347;2;345;6;339;221;66;26;90;22;21;30;84;0
ARABA-?LAVA;36;LAUDIO / LLODIO;1;3;B;560;324;3;321;8;313;236;67;26;64;18;15;24;99;0
ARABA-?LAVA;36;LAUDIO / LLODIO;1;4;U;858;566;6;560;10;550;292;180;74;116;16;36;36;92;0
ARABA-?LAVA;36;LAUDIO / LLODIO;1;5;A;804;499;3;496;7;489;305;137;42;150;10;41;43;64;2
ARABA-?LAVA;36;LAUDIO / LLODIO;1;5;B;851;514;0;514;5;509;337;132;49;140;22;41;32;90;3
ARABA-?LAVA;36;LAUDIO / LLODIO;1;6;A;803;505;6;499;8;491;298;164;74;96;24;42;17;72;2
ARABA-?LAVA;36;LAUDIO / LLODIO;1;6;B;808;530;8;522;2;520;278;171;97;77;22;51;31;71;0
ARABA-?LAVA;36;LAUDIO / LLODIO;1;7;A;696;450;7;443;7;436;246;108;63;79;28;45;30;82;1
ARABA-?LAVA;36;LAUDIO / LLODIO;1;7;B;619;358;5;353;8;345;261;82;57;60;16;24;33;72;1
ARABA-?LAVA;36;LAUDIO / LLODIO;1;8;A;570;353;7;346;5;341;217;74;52;64;23;19;33;75;1
ARABA-?LAVA;36;LAUDIO / LLODIO;1;8;B;645;368;1;367;7;360;277;76;50;80;24;19;40;71;0
ARABA-?LAVA;36;LAUDIO / LLODIO;1;9;A;869;541;4;537;13;524;328;153;78;111;22;47;39;72;2
ARABA-?LAVA;36;LAUDIO / LLODIO;1;9;B;896;575;8;567;7;560;321;158;73;144;26;35;40;84;0
ARABA-?LAVA;36;LAUDIO / LLODIO;1;10;A;601;372;0;372;8;364;229;115;41;81;23;27;35;42;0
ARABA-?LAVA;36;LAUDIO / LLODIO;1;10;B;634;384;1;383;8;375;250;119;46;66;16;34;33;60;1
ARABA-?LAVA;36;LAUDIO / LLODIO;1;11;U;804;500;9;491;7;484;304;191;45;84;14;54;31;63;2
ARABA-?LAVA;36;LAUDIO / LLODIO;1;12;U;824;527;5;522;11;511;297;124;89;68;36;23;41;128;2
ARABA-?LAVA;36;LAUDIO / LLODIO;1;13;U;903;535;2;533;7;526;368;136;55;117;19;55;27;116;1
ARABA-?LAVA;37;ARRAIA-MAEZTU;1;1;U;634;380;3;377;3;374;254;168;42;25;59;19;17;42;2
ARABA-?LAVA;39;MOREDA DE ?LAVA;1;1;U;246;181;0;181;0;181;65;81;37;2;9;2;4;46;0
ARABA-?LAVA;41;NAVARIDAS;1;1;U;186;134;5;129;0;129;52;46;56;1;7;7;4;7;1
ARABA-?LAVA;42;OKONDO;1;1;U;629;545;4;541;4;537;84;205;45;80;9;183;3;12;0
ARABA-?LAVA;43;OY?N-OION;1;1;U;964;555;2;553;3;550;409;123;173;58;62;13;37;84;0
ARABA-?LAVA;43;OY?N-OION;1;2;U;909;544;2;542;1;541;365;120;145;51;57;29;49;90;0
ARABA-?LAVA;44;PE?ACERRADA-URIZAHARRA;1;1;U;222;161;1;160;0;160;61;87;20;13;24;0;3;12;1
ARABA-?LAVA;46;RIBERA ALTA;1;1;U;477;327;0;327;3;324;150;111;58;21;81;10;16;27;0
ARABA-?LAVA;47;RIBERA BAJA / ERRIBERA BEITIA;1;1;U;352;236;0;236;2;234;116;88;57;11;30;2;17;29;0
ARABA-?LAVA;49;A?ANA;1;1;U;183;151;0;151;1;150;32;70;24;12;17;11;2;14;0
ARABA-?LAVA;51;SALVATIERRA / AGURAIN;1;1;U;641;401;3;398;3;395;240;125;35;82;61;48;17;26;1
ARABA-?LAVA;51;SALVATIERRA / AGURAIN;1;2;U;659;373;1;372;2;370;286;134;28;45;53;45;11;52;2
ARABA-?LAVA;51;SALVATIERRA / AGURAIN;1;3;A;809;458;0;458;5;453;351;94;26;68;46;50;36;131;2
ARABA-?LAVA;51;SALVATIERRA / AGURAIN;1;3;B;869;499;1;498;4;494;370;124;34;81;59;45;49;102;0
ARABA-?LAVA;52;SAMANIEGO;1;1;U;236;155;3;152;3;149;81;66;14;16;5;2;10;36;0
ARABA-?LAVA;53;SAN MILL?N / DONEMILIAGA;1;1;U;591;282;4;278;1;277;309;120;39;36;48;14;9;9;2
ARABA-?LAVA;54;URKABUSTAIZ;1;1;U;716;460;11;449;4;445;256;143;67;112;39;26;34;24;0
ARABA-?LAVA;55;VALDEGOV?A / GAUBEA;1;1;A;475;320;2;318;5;313;155;123;37;25;87;6;9;26;0
ARABA-?LAVA;55;VALDEGOV?A / GAUBEA;1;1;B;320;222;3;219;2;217;98;110;28;16;40;6;6;11;0
ARABA-?LAVA;56;HARANA / VALLE DE ARANA;1;1;U;350;211;1;210;2;208;139;104;36;13;47;3;3;2;0
ARABA-?LAVA;57;VILLABUENA DE ?LAVA / ESKUERNAGA;1;1;U;295;243;0;243;0;243;52;114;37;42;27;13;6;4;0
ARABA-?LAVA;58;LEGUTIANO;1;1;A;504;304;0;304;3;301;200;112;20;54;14;75;12;14;0
ARABA-?LAVA;58;LEGUTIANO;1;1;B;544;317;2;315;5;310;227;105;9;66;18;54;22;36;0
ARABA-?LAVA;59;VITORIA-GASTEIZ;1;1;U;528;267;4;263;4;259;261;43;45;47;47;17;31;29;0
ARABA-?LAVA;59;VITORIA-GASTEIZ;1;2;U;606;312;4;308;6;302;294;44;52;42;65;18;37;43;1
ARABA-?LAVA;59;VITORIA-GASTEIZ;1;3;U;714;321;3;318;4;314;393;37;40;60;49;20;38;70;0
ARABA-?LAVA;59;VITORIA-GASTEIZ;1;4;U;592;303;3;300;2;298;289;53;26;57;45;25;35;55;2
ARABA-?LAVA;59;VITORIA-GASTEIZ;1;5;U;774;467;1;466;3;463;307;53;76;112;81;23;51;64;3
ARABA-?LAVA;59;VITORIA-GASTEIZ;1;6;U;584;253;0;253;1;252;331;22;33;44;50;14;36;53;0
ARABA-?LAVA;59;VITORIA-GASTEIZ;1;7;U;844;471;2;469;8;461;373;57;70;67;105;41;39;81;1
ARABA-?LAVA;59;VITORIA-GASTEIZ;1;8;A;607;347;2;345;11;334;260;66;57;37;64;32;30;46;2
ARABA-?LAVA;59;VITORIA-GASTEIZ;1;8;B;677;374;6;368;5;363;303;58;51;53;81;26;26;66;2
ARABA-?LAVA;59;VITORIA-GASTEIZ;1;9;U;855;465;0;465;5;460;390;86;75;76;65;49;31;77;1
ARABA-?LAVA;59;VITORIA-GASTEIZ;1;10;U;565;296;6;290;2;288;269;39;35;61;40;28;40;44;1
ARABA-?LAVA;59;VITORIA-GASTEIZ;1;11;U;642;322;11;311;4;307;320;45;40;47;72;24;23;56;0
ARABA-?LAVA;59;VITORIA-GASTEIZ;2;1;A;501;339;4;335;1;334;162;58;107;16;82;33;17;21;0
ARABA-?LAVA;59;VITORIA-GASTEIZ;2;1;B;542;374;1;373;9;364;168;81;123;17;71;24;15;33;0
ARABA-?LAVA;59;VITORIA-GASTEIZ;2;2;U;845;598;5;593;13;580;247;111;211;20;138;48;19;33;0
ARABA-?LAVA;59;VITORIA-GASTEIZ;2;3;A;578;388;2;386;3;383;190;80;129;31;56;35;23;29;0
ARABA-?LAVA;59;VITORIA-GASTEIZ;2;3;B;639;420;4;416;2;414;219;79;126;33;89;36;22;29;0
ARABA-?LAVA;59;VITORIA-GASTEIZ;2;4;U;942;580;3;577;4;573;362;89;185;34;139;47;37;42;0
ARABA-?LAVA;59;VITORIA-GASTEIZ;2;5;U;685;417;1;416;8;408;268;88;131;25;97;26;12;29;0
ARABA-?LAVA;59;VITORIA-GASTEIZ;2;6;A;793;539;1;538;5;533;254;132;154;17;110;57;17;46;0
ARABA-?LAVA;59;VITORIA-GASTEIZ;2;6;B;845;604;1;603;9;594;241;111;200;28;126;38;29;62;0
ARABA-?LAVA;59;VITORIA-GASTEIZ;2;7;A;668;431;3;428;7;421;237;85;129;30;74;29;36;37;1
ARABA-?LAVA;59;VITORIA-GASTEIZ;2;7;B;629;416;1;415;7;408;213;66;113;23;85;41;32;48;0
ARABA-?LAVA;59;VITORIA-GASTEIZ;3;1;U;774;530;0;530;11;519;244;119;160;40;112;31;26;31;0
ARABA-?LAVA;59;VITORIA-GASTEIZ;3;2;U;1127;751;3;748;18;730;376;188;124;57;182;56;49;73;1
ARABA-?LAVA;59;VITORIA-GASTEIZ;3;3;A;625;417;0;417;1;416;208;88;120;25;97;30;18;38;0
ARABA-?LAVA;59;VITORIA-GASTEIZ;3;3;B;587;386;2;384;4;380;201;86;124;17;57;22;23;51;0
ARABA-?LAVA;59;VITORIA-GASTEIZ;3;4;A;530;340;0;340;5;335;190;66;87;21;76;27;23;35;0
ARABA-?LAVA;59;VITORIA-GASTEIZ;3;4;B;634;395;1;394;9;385;239;82;84;28;101;22;24;44;0
ARABA-?LAVA;59;VITORIA-GASTEIZ;3;4;C;610;412;1;411;10;401;198;92;89;25;84;26;35;50;0
ARABA-?LAVA;59;VITORIA-GASTEIZ;3;5;U;976;625;0;625;10;615;351;132;143;56;122;49;46;64;3
ARABA-?LAVA;59;VITORIA-GASTEIZ;3;6;U;806;489;0;489;8;481;317;85;105;44;117;32;30;68;0
ARABA-?LAVA;59;VITORIA-GASTEIZ;3;7;U;765;523;6;517;16;501;242;102;109;35;116;52;35;52;0
ARABA-?LAVA;59;VITORIA-GASTEIZ;3;8;A;502;320;5;315;3;312;182;69;52;21;71;33;23;43;0
ARABA-?LAVA;59;VITORIA-GASTEIZ;3;8;B;519;315;0;315;4;311;204;65;63;16;73;36;22;36;0
ARABA-?LAVA;59;VITORIA-GASTEIZ;3;9;A;591;359;1;358;6;352;232;63;76;28;89;27;25;44;0
ARABA-?LAVA;59;VITORIA-GASTEIZ;3;9;B;671;386;1;385;2;383;285;78;83;23;80;14;51;53;1
ARABA-?LAVA;59;VITORIA-GASTEIZ;3;10;A;632;362;1;361;3;358;270;80;91;24;65;25;27;45;1
ARABA-?LAVA;59;VITORIA-GASTEIZ;3;10;B;670;445;3;442;6;436;225;77;86;43;101;27;40;62;0
ARABA-?LAVA;59;VITORIA-GASTEIZ;3;11;A;504;317;1;316;5;311;187;65;101;22;68;14;16;25;0
ARABA-?LAVA;59;VITORIA-GASTEIZ;3;11;B;560;340;1;339;3;336;220;75;78;14;93;27;22;27;0
ARABA-?LAVA;59;VITORIA-GASTEIZ;3;12;U;852;502;1;501;6;495;350;127;89;49;98;41;38;52;1
ARABA-?LAVA;59;VITORIA-GASTEIZ;3;13;U;993;610;4;606;10;596;383;115;125;57;173;30;39;57;0
ARABA-?LAVA;59;VITORIA-GASTEIZ;3;14;A;571;318;1;317;7;310;253;51;52;45;70;15;32;43;2
ARABA-?LAVA;59;VITORIA-GASTEIZ;3;14;B;524;284;2;282;7;275;240;47;56;51;45;12;30;34;0
ARABA-?LAVA;59;VITORIA-GASTEIZ;3;15;A;466;256;1;255;4;251;210;47;31;27;55;9;34;47;1
ARABA-?LAVA;59;VITORIA-GASTEIZ;3;15;B;536;301;3;298;0;298;235;58;28;41;76;15;40;38;2
ARABA-?LAVA;59;VITORIA-GASTEIZ;3;16;U;802;498;0;498;6;492;304;97;78;41;99;25;48;102;2
ARABA-?LAVA;59;VITORIA-GASTEIZ;3;17;A;672;376;2;374;3;371;296;69;69;36;78;23;31;64;1
ARABA-?LAVA;59;VITORIA-GASTEIZ;3;17;B;821;479;3;476;3;473;342;77;78;51;104;31;34;97;1
ARABA-?LAVA;59;VITORIA-GASTEIZ;3;18;A;702;421;1;420;12;408;281;73;58;38;123;18;30;68;0
ARABA-?LAVA;59;VITORIA-GASTEIZ;3;18;B;716;416;4;412;3;409;300;65;50;55;96;20;36;85;2
ARABA-?LAVA;59;VITORIA-GASTEIZ;3;19;A;609;392;1;391;5;386;217;82;47;48;79;13;45;70;2
ARABA-?LAVA;59;VITORIA-GASTEIZ;3;19;B;607;369;1;368;6;362;238;61;49;34;85;18;39;75;1
ARABA-?LAVA;59;VITORIA-GASTEIZ;3;20;A;775;468;3;465;8;457;307;81;72;32;126;21;34;90;1
ARABA-?LAVA;59;VITORIA-GASTEIZ;3;20;B;823;494;3;491;7;484;329;82;103;28;110;22;48;91;0
ARABA-?LAVA;59;VITORIA-GASTEIZ;3;21;U;922;552;3;549;8;541;370;91;106;49;125;24;42;103;1
ARABA-?LAVA;59;VITORIA-GASTEIZ;3;22;A;569;308;9;299;6;293;261;49;45;25;71;17;35;48;3
ARABA-?LAVA;59;VITORIA-GASTEIZ;3;22;B;606;322;4;318;11;307;284;49;61;23;67;16;40;51;0
ARABA-?LAVA;59;VITORIA-GASTEIZ;3;23;A;574;330;1;329;4;325;244;54;54;26;86;17;34;52;2
ARABA-?LAVA;59;VITORIA-GASTEIZ;3;23;B;599;353;2;351;2;349;246;45;54;24;86;23;42;75;0
ARABA-?LAVA;59;VITORIA-GASTEIZ;3;24;A;749;451;3;448;12;436;298;92;80;26;105;27;49;56;1
ARABA-?LAVA;59;VITORIA-GASTEIZ;3;24;B;737;439;0;439;3;436;298;86;72;29;112;23;52;61;1
ARABA-?LAVA;59;VITORIA-GASTEIZ;3;25;A;676;441;1;440;8;432;235;86;98;19;109;35;40;45;0
ARABA-?LAVA;59;VITORIA-GASTEIZ;3;25;B;701;459;0;459;10;449;242;98;83;12;117;48;41;50;0
ARABA-?LAVA;59;VITORIA-GASTEIZ;3;26;A;810;557;5;552;11;541;253;76;128;32;159;24;53;68;1
ARABA-?LAVA;59;VITORIA-GASTEIZ;3;26;B;761;500;3;497;10;487;261;84;93;29;127;41;50;63;0
ARABA-?LAVA;59;VITORIA-GASTEIZ;3;27;A;636;368;1;367;10;357;268;59;74;22;75;13;31;82;1
ARABA-?LAVA;59;VITORIA-GASTEIZ;3;27;B;725;410;2;408;4;404;315;55;65;23;105;20;45;91;0
ARABA-?LAVA;59;VITORIA-GASTEIZ;3;28;A;607;326;1;325;25;300;281;36;48;23;69;6;44;71;3
ARABA-?LAVA;59;VITORIA-GASTEIZ;3;28;B;632;305;4;301;3;298;327;45;31;17;83;7;42;71;2
ARABA-?LAVA;59;VITORIA-GASTEIZ;3;29;U;948;565;3;562;13;549;383;84;69;34;161;27;54;117;3
ARABA-?LAVA;59;VITORIA-GASTEIZ;3;30;A;808;588;1;587;11;576;220;144;135;25;146;44;43;39;0
ARABA-?LAVA;59;VITORIA-GASTEIZ;3;30;B;909;633;3;630;16;614;276;122;148;32;168;41;50;53;0
ARABA-?LAVA;59;VITORIA-GASTEIZ;3;31;A;655;425;1;424;12;412;230;88;99;31;96;39;19;38;2
ARABA-?LAVA;59;VITORIA-GASTEIZ;3;31;B;671;417;2;415;8;407;254;69;108;43;91;29;30;37;0
ARABA-?LAVA;59;VITORIA-GASTEIZ;3;32;A;770;498;4;494;6;488;272;116;85;40;116;29;35;65;2
ARABA-?LAVA;59;VITORIA-GASTEIZ;3;32;B;819;543;9;534;5;529;276;83;95;39;145;29;61;74;3
ARABA-?LAVA;59;VITORIA-GASTEIZ;3;33;A;626;411;0;411;8;403;215;75;107;13;102;32;37;37;0
ARABA-?LAVA;59;VITORIA-GASTEIZ;3;33;B;607;427;4;423;9;414;180;62;105;31;102;30;33;50;1
ARABA-?LAVA;59;VITORIA-GASTEIZ;3;33;C;559;371;1;370;9;361;188;68;87;22;86;33;25;40;0
ARABA-?LAVA;59;VITORIA-GASTEIZ;3;34;U;989;583;2;581;6;575;406;68;80;38;148;18;72;150;1
ARABA-?LAVA;59;VITORIA-GASTEIZ;3;35;A;590;391;3;388;5;383;199;41;59;40;104;12;58;68;1
ARABA-?LAVA;59;VITORIA-GASTEIZ;3;35;B;658;411;7;404;10;394;247;79;42;39;101;21;42;69;1
ARABA-?LAVA;59;VITORIA-GASTEIZ;3;36;U;751;411;4;407;4;403;340;71;73;26;103;19;33;78;0
ARABA-?LAVA;59;VITORIA-GASTEIZ;3;37;A;590;382;0;382;8;374;208;68;60;28;106;23;34;55;0
ARABA-?LAVA;59;VITORIA-GASTEIZ;3;37;B;594;417;5;412;10;402;177;75;62;34;106;28;28;67;2
ARABA-?LAVA;59;VITORIA-GASTEIZ;3;38;A;655;382;2;380;11;369;273;70;63;18;81;11;38;88;0
ARABA-?LAVA;59;VITORIA-GASTEIZ;3;38;B;618;383;5;378;6;372;235;57;38;26;82;24;56;89;0
ARABA-?LAVA;59;VITORIA-GASTEIZ;3;39;A;602;374;2;372;10;362;228;51;68;27;86;24;37;68;1
ARABA-?LAVA;59;VITORIA-GASTEIZ;3;39;B;589;369;2;367;6;361;220;55;48;20;87;20;34;96;1
ARABA-?LAVA;59;VITORIA-GASTEIZ;3;40;A;649;461;1;460;13;447;188;72;92;31;128;30;40;54;0
ARABA-?LAVA;59;VITORIA-GASTEIZ;3;40;B;649;463;3;460;7;453;186;69;72;27;136;31;44;73;1
ARABA-?LAVA;59;VITORIA-GASTEIZ;3;41;A;739;470;1;469;17;452;269;117;65;28;110;25;57;50;0
ARABA-?LAVA;59;VITORIA-GASTEIZ;3;41;B;768;452;0;452;13;439;316;115;53;39;80;36;63;51;2
ARABA-?LAVA;59;VITORIA-GASTEIZ;3;42;A;556;365;1;364;9;355;191;85;44;24;82;28;42;49;1
ARABA-?LAVA;59;VITORIA-GASTEIZ;3;42;B;601;402;1;401;10;391;199;65;48;35;94;37;47;64;1
ARABA-?LAVA;59;VITORIA-GASTEIZ;3;43;U;919;596;3;593;8;585;323;95;113;55;143;37;74;67;1
ARABA-?LAVA;59;VITORIA-GASTEIZ;3;44;U;1034;683;4;679;11;668;351;138;78;58;149;42;104;97;2
ARABA-?LAVA;59;VITORIA-GASTEIZ;4;1;A;555;321;0;321;8;313;234;56;47;32;52;19;24;82;1
ARABA-?LAVA;59;VITORIA-GASTEIZ;4;1;B;604;335;0;335;6;329;269;75;36;41;52;28;35;61;1
ARABA-?LAVA;59;VITORIA-GASTEIZ;4;1;C;625;368;5;363;3;360;257;70;44;37;62;27;40;80;0
ARABA-?LAVA;59;VITORIA-GASTEIZ;4;2;A;762;454;3;451;0;451;308;75;58;32;89;21;55;121;0
ARABA-?LAVA;59;VITORIA-GASTEIZ;4;2;B;677;389;5;384;3;381;288;53;43;39;98;15;42;90;1
ARABA-?LAVA;59;VITORIA-GASTEIZ;4;3;A;621;331;3;328;4;324;290;50;41;22;78;23;33;77;0
ARABA-?LAVA;59;VITORIA-GASTEIZ;4;3;B;733;428;2;426;5;421;305;67;54;29;114;20;35;102;0
ARABA-?LAVA;59;VITORIA-GASTEIZ;4;4;A;553;334;2;332;6;326;219;61;37;16;85;11;48;68;0
ARABA-?LAVA;59;VITORIA-GASTEIZ;4;4;B;536;349;4;345;11;334;187;54;34;21;101;13;37;73;1
ARABA-?LAVA;59;VITORIA-GASTEIZ;4;5;U;860;516;1;515;5;510;344;88;52;48;92;9;85;136;0
ARABA-?LAVA;59;VITORIA-GASTEIZ;4;6;A;656;387;2;385;8;377;269;52;34;53;80;12;42;103;1
ARABA-?LAVA;59;VITORIA-GASTEIZ;4;6;B;622;364;1;363;12;351;258;45;32;43;64;24;44;99;0
ARABA-?LAVA;59;VITORIA-GASTEIZ;4;7;A;618;392;7;385;9;376;226;75;47;49;76;37;55;37;0
ARABA-?LAVA;59;VITORIA-GASTEIZ;4;7;B;730;451;0;451;7;444;279;105;46;50;97;36;40;68;2
ARABA-?LAVA;59;VITORIA-GASTEIZ;4;8;A;534;299;2;297;5;292;235;58;44;18;52;10;34;76;0
ARABA-?LAVA;59;VITORIA-GASTEIZ;4;8;B;551;332;0;332;6;326;219;68;52;22;54;14;42;74;0
ARABA-?LAVA;59;VITORIA-GASTEIZ;4;9;U;587;325;0;325;3;322;262;30;30;30;85;9;32;106;0
ARABA-?LAVA;59;VITORIA-GASTEIZ;4;10;U;962;532;3;529;4;525;430;95;53;64;105;33;56;118;1
ARABA-?LAVA;59;VITORIA-GASTEIZ;4;11;U;834;517;2;515;4;511;317;132;92;77;80;38;49;42;1
ARABA-?LAVA;59;VITORIA-GASTEIZ;4;12;U;992;523;1;522;8;514;469;102;60;47;101;21;72;108;3
ARABA-?LAVA;59;VITORIA-GASTEIZ;4;13;A;493;338;0;338;3;335;155;87;78;34;52;28;16;40;0
ARABA-?LAVA;59;VITORIA-GASTEIZ;4;13;B;626;404;2;402;8;394;222;96;83;42;89;25;25;33;1
ARABA-?LAVA;59;VITORIA-GASTEIZ;4;14;A;566;358;1;357;6;351;208;65;63;32;81;49;28;33;0
ARABA-?LAVA;59;VITORIA-GASTEIZ;4;14;B;577;330;0;330;6;324;247;65;60;45;52;23;26;53;0
ARABA-?LAVA;59;VITORIA-GASTEIZ;4;14;C;601;353;3;350;7;343;248;63;59;32;75;31;42;38;3
ARABA-?LAVA;59;VITORIA-GASTEIZ;4;15;A;725;451;1;450;9;441;274;82;58;50;86;28;55;81;1
ARABA-?LAVA;59;VITORIA-GASTEIZ;4;15;B;828;509;5;504;11;493;319;73;78;58;112;32;52;84;4
ARABA-?LAVA;59;VITORIA-GASTEIZ;4;16;A;547;306;4;302;6;296;241;67;49;38;54;17;20;51;0
ARABA-?LAVA;59;VITORIA-GASTEIZ;4;16;B;538;323;0;323;3;320;215;51;45;34;77;25;31;57;0
ARABA-?LAVA;59;VITORIA-GASTEIZ;4;17;U;952;553;6;547;3;544;399;96;76;62;79;32;79;119;1
ARABA-?LAVA;59;VITORIA-GASTEIZ;4;18;U;868;505;8;497;5;492;363;95;53;57;93;38;46;106;4
ARABA-?LAVA;59;VITORIA-GASTEIZ;4;19;A;696;417;1;416;1;415;279;51;52;37;101;29;46;99;0
ARABA-?LAVA;59;VITORIA-GASTEIZ;4;19;B;772;473;3;470;5;465;299;65;51;43;104;42;55;105;0
ARABA-?LAVA;59;VITORIA-GASTEIZ;4;20;A;605;336;3;333;10;323;269;60;36;29;65;24;45;64;0
ARABA-?LAVA;59;VITORIA-GASTEIZ;4;20;B;621;366;1;365;12;353;255;44;47;37;74;24;49;78;0
ARABA-?LAVA;59;VITORIA-GASTEIZ;4;21;A;477;241;0;241;5;236;236;24;32;25;42;17;38;57;1
ARABA-?LAVA;59;VITORIA-GASTEIZ;4;21;B;539;306;0;306;8;298;233;36;40;39;58;9;44;71;1
ARABA-?LAVA;59;VITORIA-GASTEIZ;4;22;A;652;405;8;397;9;388;247;60;45;45;76;27;49;85;1
ARABA-?LAVA;59;VITORIA-GASTEIZ;4;22;B;688;403;7;396;9;387;285;76;35;50;84;29;36;76;1
ARABA-?LAVA;59;VITORIA-GASTEIZ;4;23;U;810;496;1;495;10;485;314;122;43;69;70;45;64;72;0
ARABA-?LAVA;59;VITORIA-GASTEIZ;4;24;A;720;415;3;412;5;407;305;84;60;43;81;29;42;67;1
ARABA-?LAVA;59;VITORIA-GASTEIZ;4;24;B;708;449;2;447;9;438;259;99;65;39;88;32;47;68;0
ARABA-?LAVA;59;VITORIA-GASTEIZ;4;25;U;895;509;2;507;10;497;386;82;65;51;108;28;61;101;1
ARABA-?LAVA;59;VITORIA-GASTEIZ;4;26;U;709;417;3;414;7;407;292;85;48;28;102;24;44;75;1
ARABA-?LAVA;59;VITORIA-GASTEIZ;4;27;U;1043;652;0;652;10;642;391;102;80;46;148;36;86;142;2
ARABA-?LAVA;59;VITORIA-GASTEIZ;4;28;A;795;480;1;479;6;473;315;80;70;40;112;15;57;98;1
ARABA-?LAVA;59;VITORIA-GASTEIZ;4;28;B;764;484;2;482;3;479;280;58;66;31;98;58;58;110;0
ARABA-?LAVA;59;VITORIA-GASTEIZ;4;29;A;603;355;1;354;8;346;248;59;44;42;76;27;50;47;1
ARABA-?LAVA;59;VITORIA-GASTEIZ;4;29;B;682;381;1;380;9;371;301;67;43;40;76;33;54;57;1
ARABA-?LAVA;59;VITORIA-GASTEIZ;4;30;A;763;426;7;419;6;413;337;71;40;30;79;25;69;98;1
ARABA-?LAVA;59;VITORIA-GASTEIZ;4;30;B;779;435;1;434;8;426;344;82;41;42;80;18;69;92;2
ARABA-?LAVA;59;VITORIA-GASTEIZ;4;31;U;1070;627;0;627;14;613;443;99;93;52;109;39;96;123;2
ARABA-?LAVA;59;VITORIA-GASTEIZ;4;32;U;795;467;4;463;16;447;328;85;50;37;97;30;57;90;1
ARABA-?LAVA;59;VITORIA-GASTEIZ;4;33;U;780;439;8;431;7;424;341;44;37;48;78;18;51;143;5
ARABA-?LAVA;59;VITORIA-GASTEIZ;4;34;U;813;524;1;523;8;515;289;99;62;66;127;49;63;46;3
ARABA-?LAVA;59;VITORIA-GASTEIZ;4;35;U;728;440;4;436;11;425;288;80;47;31;117;25;45;78;2
ARABA-?LAVA;59;VITORIA-GASTEIZ;5;1;U;626;373;3;370;6;364;253;76;68;34;60;45;32;49;0
ARABA-?LAVA;59;VITORIA-GASTEIZ;5;2;A;578;365;4;361;7;354;213;53;43;35;77;25;46;73;2
ARABA-?LAVA;59;VITORIA-GASTEIZ;5;2;B;615;367;9;358;7;351;248;52;38;50;83;31;37;58;2
ARABA-?LAVA;59;VITORIA-GASTEIZ;5;3;U;777;478;2;476;9;467;299;77;68;49;121;34;47;70;1
ARABA-?LAVA;59;VITORIA-GASTEIZ;5;4;U;678;452;5;447;10;437;226;91;99;27;100;53;32;35;0
ARABA-?LAVA;59;VITORIA-GASTEIZ;5;5;U;725;495;2;493;8;485;230;114;129;20;132;34;24;30;2
ARABA-?LAVA;59;VITORIA-GASTEIZ;5;6;A;669;453;2;451;9;442;216;104;86;37;90;42;28;53;2
ARABA-?LAVA;59;VITORIA-GASTEIZ;5;6;B;643;397;1;396;7;389;246;67;85;25;85;54;25;48;0
ARABA-?LAVA;59;VITORIA-GASTEIZ;5;7;U;966;636;2;634;9;625;330;124;107;69;158;73;39;55;0
ARABA-?LAVA;59;VITORIA-GASTEIZ;5;8;A;520;359;0;359;7;352;161;76;62;19;94;38;31;32;0
ARABA-?LAVA;59;VITORIA-GASTEIZ;5;8;B;585;366;0;366;9;357;219;66;88;28;95;30;27;22;1
ARABA-?LAVA;59;VITORIA-GASTEIZ;5;9;A;597;381;2;379;3;376;216;85;86;23;83;33;31;34;1
ARABA-?LAVA;59;VITORIA-GASTEIZ;5;9;B;618;389;1;388;5;383;229;85;88;33;87;29;31;30;0
ARABA-?LAVA;59;VITORIA-GASTEIZ;5;10;U;708;395;5;390;4;386;313;62;47;54;72;22;42;87;0
ARABA-?LAVA;59;VITORIA-GASTEIZ;5;11;U;905;519;1;518;7;511;386;96;72;78;70;36;64;92;3
ARABA-?LAVA;59;VITORIA-GASTEIZ;5;12;A;536;348;3;345;10;335;188;73;73;23;72;44;16;34;0
ARABA-?LAVA;59;VITORIA-GASTEIZ;5;12;B;515;360;2;358;2;356;155;76;98;23;78;37;18;26;0
ARABA-?LAVA;59;VITORIA-GASTEIZ;5;13;A;694;411;3;408;11;397;283;81;37;32;104;26;50;65;2
ARABA-?LAVA;59;VITORIA-GASTEIZ;5;13;B;784;459;8;451;5;446;325;83;51;33;127;34;54;63;1
ARABA-?LAVA;59;VITORIA-GASTEIZ;5;14;U;946;533;3;530;14;516;413;86;59;43;107;26;103;91;1
ARABA-?LAVA;59;VITORIA-GASTEIZ;5;15;U;717;408;1;407;6;401;309;70;53;47;85;27;51;67;1
ARABA-?LAVA;59;VITORIA-GASTEIZ;5;16;A;542;350;4;346;8;338;192;60;42;16;85;27;66;41;1
ARABA-?LAVA;59;VITORIA-GASTEIZ;5;16;B;665;391;2;389;5;384;274;73;33;43;103;27;55;49;1
ARABA-?LAVA;59;VITORIA-GASTEIZ;5;17;A;738;475;6;469;13;456;263;102;59;47;112;36;35;65;0
ARABA-?LAVA;59;VITORIA-GASTEIZ;5;17;B;818;500;4;496;8;488;318;98;66;51;120;41;44;67;1
ARABA-?LAVA;59;VITORIA-GASTEIZ;5;18;U;867;506;0;506;8;498;361;86;37;67;119;37;75;77;0
ARABA-?LAVA;59;VITORIA-GASTEIZ;5;19;U;881;487;6;481;6;475;394;83;65;51;90;25;69;90;2
ARABA-?LAVA;59;VITORIA-GASTEIZ;5;20;A;529;325;0;325;7;318;204;66;44;30;89;23;31;35;0
ARABA-?LAVA;59;VITORIA-GASTEIZ;5;20;B;546;350;2;348;5;343;196;58;54;28;86;19;49;47;2
ARABA-?LAVA;59;VITORIA-GASTEIZ;6;1;A;751;396;1;395;4;391;355;78;48;53;39;17;44;110;2
ARABA-?LAVA;59;VITORIA-GASTEIZ;6;1;B;800;405;11;394;8;386;395;60;58;33;64;20;37;113;1
ARABA-?LAVA;59;VITORIA-GASTEIZ;6;2;U;1003;615;2;613;12;601;388;103;90;40;157;50;58;103;0
ARABA-?LAVA;59;VITORIA-GASTEIZ;6;3;A;757;444;2;442;9;433;313;77;63;49;116;16;56;54;2
ARABA-?LAVA;59;VITORIA-GASTEIZ;6;3;B;863;481;1;480;9;471;382;65;67;41;132;19;56;90;1
ARABA-?LAVA;59;VITORIA-GASTEIZ;6;4;A;555;335;2;333;7;326;220;50;33;33;88;14;48;60;0
ARABA-?LAVA;59;VITORIA-GASTEIZ;6;4;B;544;322;2;320;6;314;222;53;28;35;79;15;61;41;2
ARABA-?LAVA;59;VITORIA-GASTEIZ;6;5;U;1006;523;2;521;4;517;483;88;66;54;62;33;75;137;2
ARABA-?LAVA;59;VITORIA-GASTEIZ;6;6;A;718;387;2;385;5;380;331;73;45;40;73;11;45;91;2
ARABA-?LAVA;59;VITORIA-GASTEIZ;6;6;B;704;380;2;378;9;369;324;62;60;32;75;17;47;74;2
ARABA-?LAVA;59;VITORIA-GASTEIZ;6;7;U;929;528;5;523;8;515;401;80;68;67;102;36;62;99;1
ARABA-?LAVA;59;VITORIA-GASTEIZ;6;8;A;757;429;2;427;10;417;328;64;81;39;99;17;51;64;2
ARABA-?LAVA;59;VITORIA-GASTEIZ;6;8;B;806;442;2;440;5;435;364;73;78;40;112;22;40;69;1
ARABA-?LAVA;59;VITORIA-GASTEIZ;6;9;U;715;392;4;388;9;379;323;54;51;41;78;31;44;80;0
ARABA-?LAVA;59;VITORIA-GASTEIZ;6;10;A;490;256;1;255;8;247;234;60;97;9;46;17;6;11;1
ARABA-?LAVA;59;VITORIA-GASTEIZ;6;10;B;462;223;2;221;3;218;239;50;56;3;64;19;6;20;0
ARABA-?LAVA;59;VITORIA-GASTEIZ;6;11;U;800;569;1;568;10;558;231;143;167;9;132;59;9;38;1
ARABA-?LAVA;59;VITORIA-GASTEIZ;6;12;A;871;559;4;555;11;544;312;99;83;31;117;24;66;124;0
ARABA-?LAVA;59;VITORIA-GASTEIZ;6;12;B;911;553;11;542;8;534;358;91;62;30;129;37;69;116;0
ARABA-?LAVA;59;VITORIA-GASTEIZ;6;13;U;989;583;4;579;15;564;406;116;65;45;94;25;63;155;1
ARABA-?LAVA;59;VITORIA-GASTEIZ;6;14;U;559;333;2;331;9;322;226;39;31;22;85;10;41;93;1
ARABA-?LAVA;59;VITORIA-GASTEIZ;6;15;A;570;335;0;335;9;326;235;66;54;32;80;13;25;55;1
ARABA-?LAVA;59;VITORIA-GASTEIZ;6;15;B;558;351;1;350;6;344;207;52;71;29;88;17;37;49;1
ARABA-?LAVA;59;VITORIA-GASTEIZ;6;16;U;682;402;0;402;7;395;280;72;69;35;93;26;33;67;0
ARABA-?LAVA;59;VITORIA-GASTEIZ;6;17;A;628;430;0;430;8;422;198;129;105;24;82;21;18;43;0
ARABA-?LAVA;59;VITORIA-GASTEIZ;6;17;B;615;432;1;431;6;425;183;116;99;19;107;35;20;29;0
ARABA-?LAVA;59;VITORIA-GASTEIZ;6;18;U;531;329;1;328;7;321;202;50;44;18;80;19;54;56;0
ARABA-?LAVA;59;VITORIA-GASTEIZ;6;19;U;690;409;1;408;6;402;281;77;65;28;89;14;55;73;1
ARABA-?LAVA;59;VITORIA-GASTEIZ;6;20;U;923;559;0;559;4;555;364;82;51;45;107;41;115;112;2
ARABA-?LAVA;59;VITORIA-GASTEIZ;6;21;U;550;345;6;339;6;333;205;67;58;26;64;15;50;52;1
ARABA-?LAVA;59;VITORIA-GASTEIZ;7;1;A;581;321;0;321;6;315;260;69;68;23;67;12;30;45;1
ARABA-?LAVA;59;VITORIA-GASTEIZ;7;1;B;506;256;0;256;6;250;250;57;52;24;71;17;15;11;3
ARABA-?LAVA;59;VITORIA-GASTEIZ;7;2;A;269;174;0;174;1;173;95;48;40;15;42;7;12;8;1
ARABA-?LAVA;59;VITORIA-GASTEIZ;7;2;B;965;493;3;490;5;485;472;123;93;32;88;42;36;70;1
ARABA-?LAVA;59;VITORIA-GASTEIZ;7;3;A;316;137;1;136;5;131;179;37;19;27;17;11;6;14;0
ARABA-?LAVA;59;VITORIA-GASTEIZ;7;3;B;458;235;2;233;2;231;223;61;44;35;61;10;8;12;0
ARABA-?LAVA;59;VITORIA-GASTEIZ;7;4;U;991;520;0;520;5;515;471;82;39;70;65;13;44;199;3
ARABA-?LAVA;59;VITORIA-GASTEIZ;7;5;U;669;325;3;322;6;316;344;37;22;31;33;4;33;156;0
ARABA-?LAVA;59;VITORIA-GASTEIZ;7;6;A;699;362;3;359;3;356;337;38;24;28;46;16;37;163;4
ARABA-?LAVA;59;VITORIA-GASTEIZ;7;6;B;657;370;3;367;4;363;287;54;19;33;51;6;44;156;0
ARABA-?LAVA;59;VITORIA-GASTEIZ;7;7;A;499;271;0;271;3;268;228;47;34;38;50;9;28;60;2
ARABA-?LAVA;59;VITORIA-GASTEIZ;7;7;B;554;316;1;315;5;310;238;57;42;42;59;15;27;67;1
ARABA-?LAVA;59;VITORIA-GASTEIZ;7;8;A;623;345;1;344;6;338;278;54;25;30;92;17;54;64;2
ARABA-?LAVA;59;VITORIA-GASTEIZ;7;8;B;618;325;1;324;6;318;293;54;37;28;77;13;51;55;3
ARABA-?LAVA;59;VITORIA-GASTEIZ;7;9;A;783;421;1;420;5;415;362;47;127;23;96;13;37;72;0
ARABA-?LAVA;59;VITORIA-GASTEIZ;7;9;B;780;436;1;435;5;430;344;49;111;36;96;11;64;63;0
ARABA-?LAVA;59;VITORIA-GASTEIZ;7;10;A;809;430;3;427;6;421;379;55;64;32;91;12;56;110;1
ARABA-?LAVA;59;VITORIA-GASTEIZ;7;10;B;861;443;2;441;2;439;418;56;65;32;103;11;72;99;1
ARABA-?LAVA;59;VITORIA-GASTEIZ;7;11;A;869;413;4;409;6;403;456;90;19;29;63;8;45;146;3
ARABA-?LAVA;59;VITORIA-GASTEIZ;7;11;B;663;333;3;330;11;319;330;32;28;33;60;8;47;109;2
ARABA-?LAVA;59;VITORIA-GASTEIZ;7;12;A;607;342;2;340;7;333;265;41;37;48;49;16;67;74;1
ARABA-?LAVA;59;VITORIA-GASTEIZ;7;12;B;636;332;0;332;6;326;304;45;28;27;71;13;72;68;2
ARABA-?LAVA;59;VITORIA-GASTEIZ;7;13;A;768;470;6;464;10;454;298;83;59;36;125;22;72;57;0
ARABA-?LAVA;59;VITORIA-GASTEIZ;7;13;B;728;419;3;416;9;407;309;77;51;36;96;17;71;59;0
ARABA-?LAVA;59;VITORIA-GASTEIZ;7;14;U;849;471;4;467;12;455;378;72;58;38;115;12;85;74;1
ARABA-?LAVA;59;VITORIA-GASTEIZ;7;15;A;760;455;4;451;5;446;305;62;47;40;121;31;56;89;0
ARABA-?LAVA;59;VITORIA-GASTEIZ;7;15;B;807;476;1;475;13;462;331;90;43;41;126;22;58;81;1
ARABA-?LAVA;59;VITORIA-GASTEIZ;7;16;U;866;458;4;454;1;453;408;76;54;17;119;18;69;100;0
ARABA-?LAVA;59;VITORIA-GASTEIZ;7;17;U;1119;592;1;591;7;584;527;100;46;52;132;16;84;153;1
ARABA-?LAVA;59;VITORIA-GASTEIZ;7;18;A;640;374;1;373;11;362;266;51;32;35;90;21;66;65;2
ARABA-?LAVA;59;VITORIA-GASTEIZ;7;18;B;613;351;1;350;7;343;262;48;28;36;87;19;51;74;0
ARABA-?LAVA;60;Y?CORA / IEKORA;1;1;U;209;159;2;157;0;157;50;86;16;2;34;2;2;15;0
ARABA-?LAVA;61;ZALDUONDO;1;1;U;109;70;0;70;1;69;39;25;3;17;4;4;5;10;1
ARABA-?LAVA;62;ZAMBRANA;1;1;U;290;209;1;208;1;207;81;110;17;2;49;2;17;10;0
ARABA-?LAVA;63;ZUIA;1;1;A;589;420;7;413;7;406;169;173;62;57;49;30;15;20;0
ARABA-?LAVA;63;ZUIA;1;1;B;551;382;1;381;3;378;169;152;74;54;35;31;12;20;0
ARABA-?LAVA;901;IRU?A OKA / IRU?A DE OCA;1;1;A;642;411;2;409;6;403;231;87;77;14;88;12;24;101;0
ARABA-?LAVA;901;IRU?A OKA / IRU?A DE OCA;1;1;B;651;420;1;419;16;403;231;86;101;19;69;10;36;82;0
ARABA-?LAVA;902;LANTAR?N;1;1;A;388;254;0;254;1;253;134;98;45;12;73;2;12;11;0
ARABA-?LAVA;902;LANTAR?N;1;1;B;329;215;1;214;1;213;114;87;35;7;48;3;10;23;0
ARABA-?LAVA;999;MUNICIPIO CERA ARABA;1;1;U;1182;269;0;269;1;268;913;56;64;14;20;28;16;66;4
GIPUZKOA;1;ABALTZISKETA;1;1;U;238;121;1;120;0;120;117;24;3;43;0;50;0;0;0
GIPUZKOA;2;ADUNA;1;1;U;249;170;0;170;4;166;79;24;1;70;0;64;5;2;0
GIPUZKOA;3;AIZARNAZABAL;1;1;U;407;277;2;275;6;269;130;51;5;150;0;57;0;6;0
GIPUZKOA;4;ALBIZTUR;1;1;U;238;113;0;113;5;108;125;42;5;24;0;37;0;0;0
GIPUZKOA;5;ALEGIA;1;1;A;791;521;3;518;8;510;270;117;17;190;0;157;11;18;0
GIPUZKOA;5;ALEGIA;1;1;B;578;350;1;349;2;347;228;66;10;113;0;127;11;20;0
GIPUZKOA;6;ALKIZA;1;1;U;220;86;0;86;2;84;134;23;1;26;1;32;1;0;0
GIPUZKOA;7;ALTZO;1;1;U;266;170;0;170;3;167;96;54;1;91;0;21;0;0;0
GIPUZKOA;8;AMEZKETA;1;1;U;851;407;0;407;3;404;444;111;22;170;0;90;3;7;1
GIPUZKOA;9;ANDOAIN;1;1;A;614;367;3;364;8;356;247;90;43;68;4;83;20;47;1
GIPUZKOA;9;ANDOAIN;1;1;B;513;301;4;297;4;293;212;68;25;57;0;62;27;51;3
GIPUZKOA;9;ANDOAIN;1;2;A;589;365;2;363;7;356;224;65;18;93;0;119;19;42;0
GIPUZKOA;9;ANDOAIN;1;2;B;469;306;1;305;4;301;163;52;16;117;1;73;13;29;0
GIPUZKOA;9;ANDOAIN;1;3;U;567;296;0;296;6;290;271;44;32;100;2;46;20;46;0
GIPUZKOA;9;ANDOAIN;1;4;A;591;309;3;306;7;299;282;60;26;94;1;40;16;61;1
GIPUZKOA;9;ANDOAIN;1;4;B;559;311;0;311;8;303;248;49;19;99;2;36;27;71;0
GIPUZKOA;9;ANDOAIN;1;5;A;696;383;0;383;4;379;313;49;31;67;0;43;51;138;0
GIPUZKOA;9;ANDOAIN;1;5;B;592;309;5;304;6;298;283;45;30;53;2;20;50;97;1
GIPUZKOA;9;ANDOAIN;1;6;A;939;490;1;489;17;472;449;79;54;92;2;47;65;131;2
GIPUZKOA;9;ANDOAIN;1;6;B;833;462;1;461;8;453;371;67;51;69;0;47;71;147;1
GIPUZKOA;9;ANDOAIN;1;7;A;695;409;3;406;10;396;286;84;37;92;3;45;38;96;1
GIPUZKOA;9;ANDOAIN;1;7;B;676;374;0;374;10;364;302;78;29;73;2;23;40;118;1
GIPUZKOA;9;ANDOAIN;1;8;U;539;281;0;281;4;277;258;66;7;96;0;80;14;14;0
GIPUZKOA;9;ANDOAIN;1;9;A;598;311;2;309;10;299;287;64;24;85;1;38;32;54;1
GIPUZKOA;9;ANDOAIN;1;9;B;485;245;0;245;3;242;240;33;28;90;0;19;26;46;0
GIPUZKOA;9;ANDOAIN;1;10;A;800;435;2;433;8;425;365;91;35;127;1;53;31;85;2
GIPUZKOA;9;ANDOAIN;1;10;B;640;332;2;330;3;327;308;49;33;76;1;55;32;80;1
GIPUZKOA;9;ANDOAIN;1;11;U;651;399;2;397;3;394;252;104;47;84;0;69;30;59;1
GIPUZKOA;10;ANOETA;1;1;A;752;436;2;434;8;426;316;77;26;162;1;97;15;48;0
GIPUZKOA;10;ANOETA;1;1;B;622;353;3;350;9;341;269;68;14;144;1;57;11;46;0
GIPUZKOA;11;ANTZUOLA;1;1;A;580;421;0;421;8;413;159;116;13;151;0;55;11;66;1
GIPUZKOA;11;ANTZUOLA;1;1;B;682;486;6;480;13;467;196;154;16;152;1;75;17;52;0
GIPUZKOA;11;ANTZUOLA;1;1;C;383;264;3;261;9;252;119;69;9;84;0;27;8;55;0
GIPUZKOA;12;ARAMA;1;1;U;131;87;0;87;1;86;44;26;3;34;0;22;0;1;0
GIPUZKOA;13;ARETXABALETA;1;1;A;729;515;1;514;8;506;214;141;24;147;1;88;29;76;0
GIPUZKOA;13;ARETXABALETA;1;1;B;661;452;4;448;8;440;209;116;22;107;6;83;25;81;0
GIPUZKOA;13;ARETXABALETA;1;2;A;962;645;1;644;10;634;317;178;50;187;2;111;23;83;0
GIPUZKOA;13;ARETXABALETA;1;2;B;715;475;9;466;9;457;240;121;38;127;0;60;40;69;2
GIPUZKOA;13;ARETXABALETA;1;3;A;781;534;7;527;5;522;247;114;14;179;0;99;18;98;0
GIPUZKOA;13;ARETXABALETA;1;3;B;590;391;2;389;2;387;199;88;19;112;0;74;21;72;1
GIPUZKOA;13;ARETXABALETA;1;4;U;512;290;1;289;4;285;222;84;4;125;0;39;6;26;1
GIPUZKOA;14;ASTEASU;1;1;A;472;223;0;223;1;222;249;43;7;82;0;71;8;11;0
GIPUZKOA;14;ASTEASU;1;1;B;496;271;0;271;5;266;225;33;8;129;0;77;11;8;0
GIPUZKOA;15;ATAUN;1;1;A;452;345;4;341;8;333;107;106;2;116;0;105;1;3;0
GIPUZKOA;15;ATAUN;1;1;B;442;299;1;298;3;295;143;75;1;126;0;90;1;2;0
GIPUZKOA;15;ATAUN;1;2;U;527;394;2;392;8;384;133;102;0;230;0;49;2;1;0
GIPUZKOA;16;AIA;1;1;U;821;427;6;421;4;417;394;195;7;125;2;83;4;1;0
GIPUZKOA;16;AIA;1;2;U;534;330;2;328;1;327;204;178;2;74;0;72;0;1;0
GIPUZKOA;17;AZKOITIA;1;1;A;640;405;4;401;9;392;235;191;18;72;0;55;14;40;2
GIPUZKOA;17;AZKOITIA;1;1;B;507;304;0;304;3;301;203;110;23;58;1;34;24;49;2
GIPUZKOA;17;AZKOITIA;1;2;U;933;634;3;631;9;622;299;279;74;98;1;88;21;59;2
GIPUZKOA;17;AZKOITIA;2;1;U;768;509;4;505;7;498;259;261;46;67;1;71;17;35;0
GIPUZKOA;17;AZKOITIA;2;2;A;881;512;4;508;9;499;369;198;31;130;0;52;23;65;0
GIPUZKOA;17;AZKOITIA;2;2;B;691;406;4;402;4;398;285;164;25;86;0;30;30;61;2
GIPUZKOA;17;AZKOITIA;3;1;A;689;415;1;414;11;403;274;178;39;68;0;53;19;46;0
GIPUZKOA;17;AZKOITIA;3;1;B;547;314;10;304;0;304;233;122;26;43;2;46;19;46;0
GIPUZKOA;17;AZKOITIA;3;2;A;668;446;6;440;6;434;222;214;47;57;0;63;13;38;2
GIPUZKOA;17;AZKOITIA;3;2;B;571;362;3;359;5;354;209;177;16;56;0;49;12;44;0
GIPUZKOA;17;AZKOITIA;3;3;U;705;458;6;452;14;438;247;232;24;84;0;57;9;32;0
GIPUZKOA;17;AZKOITIA;3;4;U;861;594;8;586;9;577;267;351;48;76;0;53;14;35;0
GIPUZKOA;18;AZPEITIA;1;1;U;784;496;1;495;4;491;288;149;36;94;0;180;10;22;0
GIPUZKOA;18;AZPEITIA;1;2;A;695;422;5;417;5;412;273;115;31;98;1;140;11;16;0
GIPUZKOA;18;AZPEITIA;1;2;B;378;230;2;228;4;224;148;70;14;59;0;72;3;6;0
GIPUZKOA;18;AZPEITIA;1;3;A;988;616;5;611;8;603;372;201;35;137;0;197;5;28;0
GIPUZKOA;18;AZPEITIA;1;3;B;554;363;2;361;4;357;191;137;18;73;0;99;7;22;1
GIPUZKOA;18;AZPEITIA;1;4;A;939;576;3;573;3;570;363;216;31;138;0;154;8;23;0
GIPUZKOA;18;AZPEITIA;1;4;B;604;392;0;392;10;382;212;139;14;74;1;124;10;20;0
GIPUZKOA;18;AZPEITIA;1;5;A;650;432;1;431;5;426;218;157;20;85;0;149;6;9;0
GIPUZKOA;18;AZPEITIA;1;5;B;480;341;0;341;5;336;139;135;36;44;0;108;5;8;0
GIPUZKOA;18;AZPEITIA;1;6;A;969;576;0;576;8;568;393;185;23;176;0;101;16;67;0
GIPUZKOA;18;AZPEITIA;1;6;B;713;374;1;373;9;364;339;125;21;72;0;67;14;64;1
GIPUZKOA;18;AZPEITIA;1;7;A;638;358;2;356;3;353;280;163;16;92;0;79;1;2;0
GIPUZKOA;18;AZPEITIA;1;7;B;445;265;0;265;1;264;180;131;16;53;0;61;2;0;1
GIPUZKOA;18;AZPEITIA;1;8;U;563;341;3;338;0;338;222;175;10;53;0;93;4;3;0
GIPUZKOA;18;AZPEITIA;1;9;A;617;378;3;375;9;366;239;125;30;95;0;81;13;22;0
GIPUZKOA;18;AZPEITIA;1;9;B;566;325;1;324;9;315;241;106;26;82;0;74;11;16;0
GIPUZKOA;19;BEASAIN;1;1;A;556;320;0;320;4;316;236;71;19;70;2;49;18;87;0
GIPUZKOA;19;BEASAIN;1;1;B;523;327;2;325;5;320;196;77;18;67;5;37;30;86;0
GIPUZKOA;19;BEASAIN;1;2;A;904;602;3;599;13;586;302;192;40;119;0;99;35;101;0
GIPUZKOA;19;BEASAIN;1;2;B;748;466;8;458;16;442;282;129;34;89;2;81;36;70;1
GIPUZKOA;19;BEASAIN;1;3;A;730;487;4;483;6;477;243;202;36;77;0;78;24;60;0
GIPUZKOA;19;BEASAIN;1;3;B;577;381;2;379;11;368;196;110;40;77;1;59;24;57;0
GIPUZKOA;19;BEASAIN;1;4;A;553;349;0;349;5;344;204;84;16;70;2;77;22;72;1
GIPUZKOA;19;BEASAIN;1;4;B;634;422;3;419;7;412;212;123;29;72;1;78;27;82;0
GIPUZKOA;19;BEASAIN;1;4;C;478;301;0;301;7;294;177;81;27;64;0;45;17;60;0
GIPUZKOA;19;BEASAIN;1;5;A;610;399;1;398;10;388;211;125;28;87;1;94;16;37;0
GIPUZKOA;19;BEASAIN;1;5;B;407;254;1;253;2;251;153;91;18;49;0;56;15;22;0
GIPUZKOA;19;BEASAIN;1;6;U;495;320;0;320;9;311;175;99;13;109;3;69;7;11;0
GIPUZKOA;19;BEASAIN;1;7;A;577;373;4;369;7;362;204;96;30;107;3;70;19;37;0
GIPUZKOA;19;BEASAIN;1;7;B;468;323;3;320;7;313;145;76;35;54;2;66;25;54;1
GIPUZKOA;19;BEASAIN;1;8;U;845;511;4;507;11;496;334;123;40;104;1;74;50;103;1
GIPUZKOA;19;BEASAIN;1;9;U;817;451;1;450;11;439;366;78;29;97;1;31;76;127;0
GIPUZKOA;20;BEIZAMA;1;1;U;155;104;0;104;0;104;51;49;0;44;0;10;0;1;0
GIPUZKOA;21;BELAUNTZA;1;1;U;238;152;1;151;0;151;86;25;1;86;0;23;10;6;0
GIPUZKOA;22;BERASTEGI;1;1;U;765;417;1;416;2;414;348;112;7;108;0;169;10;8;0
GIPUZKOA;23;BERROBI;1;1;U;487;237;0;237;1;236;250;58;13;98;0;47;4;15;1
GIPUZKOA;24;BIDEGOIAN;1;1;U;370;239;0;239;2;237;131;72;0;69;0;95;0;1;0
GIPUZKOA;25;ZEGAMA;1;1;A;697;477;4;473;5;468;220;57;13;188;0;197;3;10;0
GIPUZKOA;25;ZEGAMA;1;1;B;452;300;1;299;2;297;152;56;8;90;0;136;3;4;0
GIPUZKOA;26;ZERAIN;1;1;U;186;116;0;116;0;116;70;38;0;44;1;31;0;2;0
GIPUZKOA;27;ZESTOA;1;1;A;1016;746;12;734;9;725;270;248;20;246;0;179;14;17;1
GIPUZKOA;27;ZESTOA;1;1;B;713;490;4;486;6;480;223;152;6;146;0;134;14;28;0
GIPUZKOA;27;ZESTOA;1;2;A;370;257;2;255;2;253;113;70;3;76;1;62;5;36;0
GIPUZKOA;27;ZESTOA;1;2;B;257;164;0;164;1;163;93;38;3;88;1;31;0;2;0
GIPUZKOA;27;ZESTOA;1;2;C;403;271;1;270;2;268;132;70;3;87;0;107;0;1;0
GIPUZKOA;28;ZIZURKIL;1;1;U;1081;678;5;673;10;663;403;155;29;274;1;112;32;60;0
GIPUZKOA;28;ZIZURKIL;1;2;U;1040;566;2;564;10;554;474;117;48;126;0;80;40;143;0
GIPUZKOA;29;DEBA;1;1;A;717;464;6;458;12;446;253;149;30;91;0;127;20;29;0
GIPUZKOA;29;DEBA;1;1;B;496;315;0;315;5;310;181;87;28;60;1;82;10;41;1
GIPUZKOA;29;DEBA;1;2;A;643;410;2;408;14;394;233;111;19;111;0;80;22;51;0
GIPUZKOA;29;DEBA;1;2;B;450;279;4;275;11;264;171;57;7;74;0;59;15;52;0
GIPUZKOA;29;DEBA;1;3;U;944;615;5;610;10;600;329;188;39;137;0;146;22;66;2
GIPUZKOA;29;DEBA;2;1;U;787;472;3;469;5;464;315;131;5;164;0;154;7;3;0
GIPUZKOA;30;EIBAR;1;1;A;649;426;0;426;7;419;223;132;53;57;0;63;26;88;0
GIPUZKOA;30;EIBAR;1;1;B;563;351;2;349;3;346;212;107;50;51;1;57;16;64;0
GIPUZKOA;30;EIBAR;1;2;A;861;499;2;497;7;490;362;140;61;102;0;73;24;90;0
GIPUZKOA;30;EIBAR;1;2;B;599;351;1;350;13;337;248;90;48;63;1;54;17;63;1
GIPUZKOA;30;EIBAR;1;3;A;646;418;0;418;9;409;228;147;54;81;1;54;18;53;1
GIPUZKOA;30;EIBAR;1;3;B;493;309;2;307;4;303;184;101;34;49;0;46;10;63;0
GIPUZKOA;30;EIBAR;1;4;A;826;461;0;461;6;455;365;91;60;83;0;46;37;138;0
GIPUZKOA;30;EIBAR;1;4;B;633;324;2;322;0;322;309;61;49;46;2;28;36;99;1
GIPUZKOA;30;EIBAR;1;5;A;713;365;0;365;8;357;348;51;51;66;0;25;44;120;0
GIPUZKOA;30;EIBAR;1;5;B;598;310;2;308;4;304;288;40;49;46;1;22;40;105;1
GIPUZKOA;30;EIBAR;2;1;A;650;359;0;359;6;353;291;69;33;81;0;67;25;78;0
GIPUZKOA;30;EIBAR;2;1;B;517;299;0;299;5;294;218;58;40;55;2;45;15;79;0
GIPUZKOA;30;EIBAR;2;2;A;717;376;0;376;9;367;341;90;40;74;0;38;33;92;0
GIPUZKOA;30;EIBAR;2;2;B;678;365;0;365;5;360;313;66;52;45;1;24;49;123;0
GIPUZKOA;30;EIBAR;2;3;A;719;399;1;398;5;393;320;50;51;49;0;18;54;171;0
GIPUZKOA;30;EIBAR;2;3;B;645;388;3;385;9;376;257;51;56;37;1;12;51;168;0
GIPUZKOA;30;EIBAR;2;4;A;695;368;5;363;6;357;327;67;68;61;2;16;32;110;1
GIPUZKOA;30;EIBAR;2;4;B;571;307;2;305;5;300;264;53;42;40;1;18;40;106;0
GIPUZKOA;30;EIBAR;2;5;U;780;488;2;486;1;485;292;176;42;82;0;94;19;72;0
GIPUZKOA;30;EIBAR;3;1;A;553;263;0;263;5;258;290;55;21;52;0;9;29;92;0
GIPUZKOA;30;EIBAR;3;1;B;531;268;2;266;5;261;263;38;39;37;1;18;32;95;1
GIPUZKOA;30;EIBAR;3;2;U;586;312;2;310;1;309;274;70;20;72;0;36;20;91;0
GIPUZKOA;30;EIBAR;3;3;A;628;378;0;378;7;371;250;82;36;94;3;46;28;82;0
GIPUZKOA;30;EIBAR;3;3;B;444;249;0;249;0;249;195;59;27;61;2;23;14;63;0
GIPUZKOA;30;EIBAR;3;4;A;484;300;0;300;6;294;184;86;29;72;0;37;11;59;0
GIPUZKOA;30;EIBAR;3;4;B;452;258;0;258;8;250;194;68;29;47;0;31;25;50;0
GIPUZKOA;30;EIBAR;4;1;A;646;358;3;355;4;351;288;77;32;91;1;46;29;75;0
GIPUZKOA;30;EIBAR;4;1;B;527;287;3;284;7;277;240;48;27;45;1;29;35;92;0
GIPUZKOA;30;EIBAR;4;2;U;772;467;1;466;10;456;305;113;53;105;0;86;36;62;1
GIPUZKOA;30;EIBAR;4;3;A;712;453;9;444;2;442;259;146;96;74;1;63;14;48;0
GIPUZKOA;30;EIBAR;4;3;B;458;304;1;303;4;299;154;95;68;38;2;57;5;34;0
GIPUZKOA;30;EIBAR;4;4;U;646;444;1;443;6;437;202;112;92;74;0;78;24;57;0
GIPUZKOA;30;EIBAR;4;5;A;568;348;0;348;5;343;220;104;40;57;0;35;24;82;1
GIPUZKOA;30;EIBAR;4;5;B;464;250;0;250;5;245;214;60;23;36;0;40;24;61;1
GIPUZKOA;30;EIBAR;4;6;A;503;282;0;282;8;274;221;78;31;58;0;66;14;27;0
GIPUZKOA;30;EIBAR;4;6;B;425;254;1;253;3;250;171;79;30;40;0;45;19;36;1
GIPUZKOA;30;EIBAR;5;1;A;655;371;3;368;6;362;284;82;41;70;1;57;27;84;0
GIPUZKOA;30;EIBAR;5;1;B;512;285;0;285;8;277;227;60;41;41;0;37;20;78;0
GIPUZKOA;30;EIBAR;5;2;A;611;387;0;387;5;382;224;154;46;54;0;64;15;49;0
GIPUZKOA;30;EIBAR;5;2;B;438;278;0;278;5;273;160;99;39;50;1;43;9;32;0
GIPUZKOA;30;EIBAR;5;3;A;721;412;1;411;5;406;309;89;54;79;3;40;42;98;1
GIPUZKOA;30;EIBAR;5;3;B;582;311;0;311;2;309;271;59;50;43;2;35;36;84;0
GIPUZKOA;30;EIBAR;5;4;U;845;478;2;476;16;460;367;124;53;104;0;79;35;65;0
GIPUZKOA;31;ELDUAIN;1;1;U;219;144;0;144;3;141;75;27;1;72;0;40;0;0;1
GIPUZKOA;32;ELGOIBAR;1;1;A;673;427;4;423;8;415;246;144;24;93;0;63;33;58;0
GIPUZKOA;32;ELGOIBAR;1;1;B;518;306;2;304;3;301;212;95;19;54;2;41;28;61;1
GIPUZKOA;32;ELGOIBAR;1;2;A;648;435;1;434;7;427;213;185;33;108;0;46;20;34;1
GIPUZKOA;32;ELGOIBAR;1;2;B;491;323;2;321;6;315;168;109;30;66;3;43;24;40;0
GIPUZKOA;32;ELGOIBAR;1;3;A;714;532;3;529;5;524;182;213;58;96;0;89;25;42;1
GIPUZKOA;32;ELGOIBAR;1;3;B;443;295;6;289;2;287;148;106;39;49;0;43;14;36;0
GIPUZKOA;32;ELGOIBAR;1;4;U;727;524;0;524;11;513;203;241;32;87;3;78;21;51;0
GIPUZKOA;32;ELGOIBAR;1;5;A;490;307;1;306;12;294;183;104;15;82;4;36;17;36;0
GIPUZKOA;32;ELGOIBAR;1;5;B;369;237;1;236;4;232;132;85;33;33;0;24;19;38;0
GIPUZKOA;32;ELGOIBAR;1;6;U;807;505;0;505;7;498;302;157;77;85;4;24;45;106;0
GIPUZKOA;32;ELGOIBAR;1;7;A;997;670;0;670;6;664;327;296;52;87;0;128;30;71;0
GIPUZKOA;32;ELGOIBAR;1;7;B;735;465;1;464;6;458;270;181;35;83;1;82;24;51;1
GIPUZKOA;32;ELGOIBAR;1;8;A;547;359;0;359;4;355;188;107;34;74;0;30;24;86;0
GIPUZKOA;32;ELGOIBAR;1;8;B;624;389;1;388;4;384;235;109;35;76;0;24;54;86;0
GIPUZKOA;32;ELGOIBAR;1;9;A;321;210;0;210;1;209;111;132;4;32;0;36;0;5;0
GIPUZKOA;32;ELGOIBAR;1;9;B;260;169;0;169;2;167;91;64;10;56;0;6;16;15;0
GIPUZKOA;33;ELGETA;1;1;U;826;528;0;528;9;519;298;239;21;159;1;54;23;22;0
GIPUZKOA;34;ESKORIATZA;1;1;A;713;445;2;443;5;438;268;82;25;111;0;124;17;78;1
GIPUZKOA;34;ESKORIATZA;1;1;B;802;474;4;470;5;465;328;93;30;91;0;98;28;125;0
GIPUZKOA;34;ESKORIATZA;1;2;A;899;564;2;562;5;557;335;138;23;178;0;148;15;55;0
GIPUZKOA;34;ESKORIATZA;1;2;B;752;434;2;432;7;425;318;96;22;111;0;120;23;53;0
GIPUZKOA;35;EZKIO-ITSASO;1;1;U;440;288;1;287;1;286;152;51;0;146;0;84;1;4;0
GIPUZKOA;36;HONDARRIBIA;1;1;A;567;286;1;285;9;276;281;86;26;71;1;47;18;26;1
GIPUZKOA;36;HONDARRIBIA;1;1;B;551;317;3;314;9;305;234;75;35;72;0;55;20;48;0
GIPUZKOA;36;HONDARRIBIA;1;2;U;790;445;1;444;25;419;345;112;33;127;1;92;26;28;0
GIPUZKOA;36;HONDARRIBIA;1;3;A;805;456;1;455;10;445;349;128;43;111;0;120;18;24;1
GIPUZKOA;36;HONDARRIBIA;1;3;B;655;384;1;383;6;377;271;118;46;92;0;93;4;24;0
GIPUZKOA;36;HONDARRIBIA;1;4;U;796;480;0;480;5;475;316;143;52;109;2;122;21;25;1
GIPUZKOA;36;HONDARRIBIA;1;5;A;802;483;1;482;7;475;319;132;34;148;0;105;21;35;0
GIPUZKOA;36;HONDARRIBIA;1;5;B;667;381;3;378;8;370;286;104;31;93;1;91;25;24;1
GIPUZKOA;36;HONDARRIBIA;1;6;U;950;479;4;475;7;468;471;102;23;159;1;117;18;47;1
GIPUZKOA;36;HONDARRIBIA;1;7;A;996;469;1;468;14;454;527;98;88;78;1;63;42;81;3
GIPUZKOA;36;HONDARRIBIA;1;7;B;858;420;7;413;7;406;438;85;87;48;2;41;36;106;1
GIPUZKOA;36;HONDARRIBIA;1;8;A;987;551;1;550;5;545;436;168;64;115;1;129;23;45;0
GIPUZKOA;36;HONDARRIBIA;1;8;B;821;435;1;434;11;423;386;118;55;97;0;94;21;36;2
GIPUZKOA;36;HONDARRIBIA;1;9;U;1034;543;1;542;29;513;491;151;79;117;0;109;23;33;1
GIPUZKOA;37;GAINTZA;1;1;U;112;56;0;56;1;55;56;12;2;24;0;17;0;0;0
GIPUZKOA;38;GABIRIA;1;1;U;361;259;0;259;0;259;102;45;6;54;0;154;0;0;0
GIPUZKOA;39;GETARIA;1;1;U;545;408;5;403;11;392;137;173;8;108;0;89;4;10;0
GIPUZKOA;39;GETARIA;1;2;A;660;504;5;499;7;492;156;211;18;135;0;108;9;11;0
GIPUZKOA;39;GETARIA;1;2;B;720;519;3;516;4;512;201;233;12;135;0;114;6;12;0
GIPUZKOA;40;HERNANI;1;1;U;583;373;0;373;6;367;210;52;11;184;0;61;20;39;0
GIPUZKOA;40;HERNANI;1;2;A;719;441;2;439;7;432;278;72;22;176;0;94;17;50;1
GIPUZKOA;40;HERNANI;1;2;B;652;394;3;391;12;379;258;56;23;140;1;80;27;51;1
GIPUZKOA;40;HERNANI;1;3;U;950;608;1;607;10;597;342;115;36;286;1;111;19;29;0
GIPUZKOA;40;HERNANI;1;4;A;779;438;1;437;22;415;341;63;24;168;1;50;45;63;1
GIPUZKOA;40;HERNANI;1;4;B;822;446;4;442;15;427;376;46;28;157;1;60;50;85;0
GIPUZKOA;40;HERNANI;1;5;A;686;373;1;372;10;362;313;40;37;132;1;48;26;77;1
GIPUZKOA;40;HERNANI;1;5;B;609;328;0;328;12;316;281;43;22;94;0;28;44;85;0
GIPUZKOA;40;HERNANI;1;6;A;545;307;3;304;8;296;238;32;25;97;1;27;27;86;1
GIPUZKOA;40;HERNANI;1;6;B;593;333;3;330;7;323;260;58;39;70;1;31;26;98;0
GIPUZKOA;40;HERNANI;1;7;A;482;263;0;263;1;262;219;39;12;83;0;32;43;52;1
GIPUZKOA;40;HERNANI;1;7;B;607;336;2;334;11;323;271;34;18;110;0;44;53;63;1
GIPUZKOA;40;HERNANI;1;8;A;649;315;0;315;3;312;334;37;18;127;1;41;32;56;0
GIPUZKOA;40;HERNANI;1;8;B;524;282;3;279;7;272;242;30;16;108;1;31;34;52;0
GIPUZKOA;40;HERNANI;1;9;U;585;359;2;357;4;353;226;53;10;244;0;37;8;1;0
GIPUZKOA;40;HERNANI;1;10;A;887;457;1;456;17;439;430;94;27;173;0;99;13;33;0
GIPUZKOA;40;HERNANI;1;10;B;714;350;2;348;9;339;364;63;18;145;0;57;17;38;1
GIPUZKOA;40;HERNANI;1;11;A;448;257;3;254;3;251;191;32;10;93;1;35;31;48;1
GIPUZKOA;40;HERNANI;1;11;B;474;235;7;228;0;228;239;22;22;56;2;27;24;75;0
GIPUZKOA;40;HERNANI;1;12;U;960;572;4;568;6;562;388;82;41;260;0;67;40;72;0
GIPUZKOA;40;HERNANI;1;13;A;573;348;0;348;6;342;225;40;25;141;1;44;19;72;0
GIPUZKOA;40;HERNANI;1;13;B;538;319;0;319;8;311;219;44;16;127;0;36;16;72;0
GIPUZKOA;40;HERNANI;1;14;U;833;449;1;448;16;432;384;68;21;130;0;54;44;114;1
GIPUZKOA;41;HERNIALDE;1;1;U;225;96;0;96;0;96;129;29;7;34;0;17;5;4;0
GIPUZKOA;42;IBARRA;1;1;A;783;455;0;455;9;446;328;95;25;152;0;94;19;60;1
GIPUZKOA;42;IBARRA;1;1;B;716;406;1;405;2;403;310;85;24;135;0;60;22;76;1
GIPUZKOA;42;IBARRA;1;2;A;650;384;4;380;3;377;266;68;15;128;1;80;36;48;1
GIPUZKOA;42;IBARRA;1;2;B;587;330;1;329;3;326;257;61;19;102;2;62;27;52;1
GIPUZKOA;42;IBARRA;1;3;U;703;411;5;406;5;401;292;89;30;136;0;80;26;40;0
GIPUZKOA;43;IDIAZABAL;1;1;A;745;512;4;508;8;500;233;165;20;114;1;177;13;10;0
GIPUZKOA;43;IDIAZABAL;1;1;B;878;547;4;543;8;535;331;162;14;146;0;191;4;18;0
GIPUZKOA;44;IKAZTEGIETA;1;1;U;303;185;1;184;1;183;118;54;7;92;1;26;1;2;0
GIPUZKOA;45;IRUN;1;1;A;935;534;2;532;19;513;401;121;152;57;1;89;29;64;0
GIPUZKOA;45;IRUN;1;1;B;799;483;0;483;13;470;316;98;169;46;3;55;34;65;0
GIPUZKOA;45;IRUN;1;2;A;674;381;2;379;10;369;293;104;64;59;3;54;19;65;1
GIPUZKOA;45;IRUN;1;2;B;585;334;0;334;11;323;251;92;58;57;1;43;15;57;0
GIPUZKOA;45;IRUN;1;3;A;767;421;7;414;19;395;346;84;118;30;2;56;41;63;1
GIPUZKOA;45;IRUN;1;3;B;696;402;1;401;16;385;294;88;116;36;0;48;40;56;1
GIPUZKOA;45;IRUN;1;4;U;1031;567;2;565;11;554;464;135;78;97;0;70;44;130;0
GIPUZKOA;45;IRUN;2;1;A;788;443;0;443;15;428;345;93;50;89;1;61;49;85;0
GIPUZKOA;45;IRUN;2;1;B;720;357;0;357;11;346;363;67;45;64;1;51;42;76;0
GIPUZKOA;45;IRUN;2;2;A;843;397;0;397;5;392;446;64;55;54;4;46;65;102;2
GIPUZKOA;45;IRUN;2;2;B;859;415;0;415;11;404;444;52;54;57;1;37;60;143;0
GIPUZKOA;45;IRUN;2;3;U;819;390;2;388;7;381;429;108;53;92;1;48;22;56;1
GIPUZKOA;45;IRUN;2;4;U;931;442;0;442;6;436;489;74;67;66;2;60;55;112;0
GIPUZKOA;45;IRUN;2;5;U;925;399;0;399;11;388;526;100;38;89;0;70;28;61;2
GIPUZKOA;45;IRUN;2;6;A;919;520;6;514;20;494;399;101;86;81;4;90;47;84;1
GIPUZKOA;45;IRUN;2;6;B;815;447;1;446;12;434;368;81;93;73;2;59;60;66;0
GIPUZKOA;45;IRUN;2;7;A;618;305;4;301;15;286;313;62;38;45;0;39;39;62;1
GIPUZKOA;45;IRUN;2;7;B;646;323;0;323;10;313;323;49;36;60;0;31;44;93;0
GIPUZKOA;45;IRUN;2;8;A;740;370;1;369;6;363;370;61;40;61;0;54;52;95;0
GIPUZKOA;45;IRUN;2;8;B;754;366;0;366;11;355;388;67;56;53;4;34;41;100;0
GIPUZKOA;45;IRUN;3;1;A;738;424;1;423;5;418;314;88;152;38;5;49;28;58;0
GIPUZKOA;45;IRUN;3;1;B;684;398;1;397;12;385;286;89;124;39;1;44;24;63;1
GIPUZKOA;45;IRUN;3;2;A;593;324;5;319;7;312;269;62;79;23;2;31;33;81;1
GIPUZKOA;45;IRUN;3;2;B;580;341;1;340;9;331;239;56;62;38;2;33;28;112;0
GIPUZKOA;45;IRUN;3;3;A;535;278;1;277;4;273;257;41;45;34;4;31;24;94;0
GIPUZKOA;45;IRUN;3;3;B;463;248;2;246;7;239;215;36;58;18;4;25;16;82;0
GIPUZKOA;45;IRUN;3;4;U;985;454;0;454;9;445;531;68;78;26;4;29;44;195;1
GIPUZKOA;45;IRUN;3;5;A;620;357;2;355;9;346;263;61;69;26;3;20;38;126;3
GIPUZKOA;45;IRUN;3;5;B;647;350;1;349;6;343;297;42;52;45;1;28;37;137;1
GIPUZKOA;45;IRUN;3;6;U;517;317;0;317;9;308;200;55;102;48;1;41;22;39;0
GIPUZKOA;45;IRUN;3;7;A;710;394;4;390;13;377;316;71;74;43;1;45;40;103;0
GIPUZKOA;45;IRUN;3;7;B;671;391;1;390;17;373;280;54;102;38;5;34;36;104;0
GIPUZKOA;45;IRUN;3;8;A;994;545;1;544;7;537;449;101;104;60;5;44;63;157;3
GIPUZKOA;45;IRUN;3;8;B;985;504;5;499;17;482;481;64;93;48;3;47;66;159;2
GIPUZKOA;45;IRUN;3;9;A;721;364;0;364;2;362;357;69;58;47;0;44;42;101;1
GIPUZKOA;45;IRUN;3;9;B;658;324;0;324;11;313;334;65;60;28;1;36;40;82;1
GIPUZKOA;45;IRUN;3;10;A;663;332;0;332;4;328;331;48;43;25;4;35;58;112;3
GIPUZKOA;45;IRUN;3;10;B;580;297;0;297;7;290;283;42;39;17;1;18;40;132;1
GIPUZKOA;45;IRUN;3;11;U;899;514;1;513;10;503;385;91;54;89;3;65;71;127;3
GIPUZKOA;45;IRUN;3;12;A;652;375;0;375;10;365;277;58;65;32;0;33;61;115;1
GIPUZKOA;45;IRUN;3;12;B;628;346;1;345;6;339;282;56;63;20;2;30;49;119;0
GIPUZKOA;45;IRUN;3;13;A;800;439;2;437;8;429;361;68;122;21;5;40;46;127;0
GIPUZKOA;45;IRUN;3;13;B;820;450;1;449;10;439;370;57;110;33;6;34;49;150;0
GIPUZKOA;45;IRUN;3;14;A;649;359;5;354;8;346;290;61;44;61;0;28;48;103;1
GIPUZKOA;45;IRUN;3;14;B;591;289;2;287;7;280;302;42;44;32;0;26;45;91;0
GIPUZKOA;45;IRUN;3;15;A;703;417;0;417;15;402;286;76;92;46;3;39;54;90;2
GIPUZKOA;45;IRUN;3;15;B;716;406;0;406;22;384;310;91;78;34;5;33;52;90;1
GIPUZKOA;45;IRUN;3;16;U;730;359;0;359;2;357;371;79;74;21;1;24;59;99;0
GIPUZKOA;45;IRUN;3;17;U;656;329;1;328;9;319;327;90;63;50;0;66;14;34;2
GIPUZKOA;45;IRUN;4;1;U;716;367;1;366;4;362;349;36;61;20;3;33;59;150;0
GIPUZKOA;45;IRUN;4;2;U;974;539;1;538;5;533;435;103;67;44;4;36;50;227;2
GIPUZKOA;45;IRUN;4;3;A;863;470;2;468;21;447;393;74;65;40;1;40;57;169;1
GIPUZKOA;45;IRUN;4;3;B;865;447;0;447;16;431;418;66;56;45;0;40;59;163;2
GIPUZKOA;45;IRUN;4;4;U;615;350;0;350;17;333;265;100;47;49;1;47;34;55;0
GIPUZKOA;45;IRUN;4;5;A;681;329;1;328;9;319;352;84;37;48;3;43;24;78;2
GIPUZKOA;45;IRUN;4;5;B;583;304;0;304;2;302;279;57;53;43;1;40;35;72;1
GIPUZKOA;45;IRUN;4;6;A;689;360;1;359;11;348;329;46;37;84;2;31;67;78;3
GIPUZKOA;45;IRUN;4;6;B;743;391;0;391;9;382;352;47;48;73;2;38;87;84;3
GIPUZKOA;45;IRUN;4;7;U;671;358;1;357;3;354;313;69;45;126;1;25;36;51;1
GIPUZKOA;45;IRUN;4;8;U;648;365;4;361;11;350;283;83;57;51;0;45;35;78;1
GIPUZKOA;46;IRURA;1;1;U;560;322;0;322;7;315;238;116;11;116;0;52;13;6;1
GIPUZKOA;47;ITSASONDO;1;1;U;536;353;1;352;3;349;183;90;15;157;0;60;13;14;0
GIPUZKOA;48;LARRAUL;1;1;U;116;56;0;56;0;56;60;21;0;25;0;9;1;0;0
GIPUZKOA;49;LAZKAO;1;1;A;733;488;1;487;8;479;245;151;29;124;0;58;34;82;1
GIPUZKOA;49;LAZKAO;1;1;B;605;397;0;397;11;386;208;106;26;91;0;32;52;79;0
GIPUZKOA;49;LAZKAO;1;2;A;729;460;0;460;8;452;269;130;23;151;0;58;32;58;0
GIPUZKOA;49;LAZKAO;1;2;B;755;463;4;459;10;449;292;129;22;148;1;54;31;64;0
GIPUZKOA;49;LAZKAO;1;3;A;558;371;1;370;7;363;187;105;20;127;0;57;15;39;0
GIPUZKOA;49;LAZKAO;1;3;B;582;378;0;378;7;371;204;100;16;143;1;63;15;33;0
GIPUZKOA;50;LEABURU;1;1;U;468;286;3;283;2;281;182;57;15;177;0;19;3;10;0
GIPUZKOA;51;LEGAZPI;1;1;A;801;528;6;522;9;513;273;132;37;107;2;134;34;66;1
GIPUZKOA;51;LEGAZPI;1;1;B;760;448;1;447;13;434;312;121;22;89;1;94;29;78;0
GIPUZKOA;51;LEGAZPI;1;2;A;802;512;1;511;14;497;290;146;65;75;2;152;15;41;1
GIPUZKOA;51;LEGAZPI;1;2;B;619;385;1;384;13;371;234;136;40;54;1;97;12;31;0
GIPUZKOA;51;LEGAZPI;1;3;A;522;333;6;327;3;324;189;71;17;71;0;80;24;61;0
GIPUZKOA;51;LEGAZPI;1;3;B;519;324;1;323;10;313;195;75;20;61;0;78;29;50;0
GIPUZKOA;51;LEGAZPI;1;4;A;584;360;5;355;5;350;224;81;25;80;0;72;21;71;0
GIPUZKOA;51;LEGAZPI;1;4;B;569;340;7;333;8;325;229;76;20;53;0;79;21;76;0
GIPUZKOA;51;LEGAZPI;1;5;A;712;414;1;413;12;401;298;83;13;88;2;45;37;133;0
GIPUZKOA;51;LEGAZPI;1;5;B;636;364;6;358;7;351;272;59;28;57;1;47;29;129;1
GIPUZKOA;51;LEGAZPI;1;6;U;815;493;0;493;5;488;322;121;23;97;0;91;41;115;0
GIPUZKOA;51;LEGAZPI;1;7;A;383;256;2;254;0;254;127;67;8;71;0;99;6;3;0
GIPUZKOA;51;LEGAZPI;1;7;B;265;157;1;156;3;153;108;49;4;45;0;23;5;26;1
GIPUZKOA;52;LEGORRETA;1;1;A;597;399;1;398;11;387;198;145;31;111;0;30;10;60;0
GIPUZKOA;52;LEGORRETA;1;1;B;602;402;3;399;9;390;200;158;31;112;0;40;12;37;0
GIPUZKOA;53;LEZO;1;1;A;729;446;7;439;7;432;283;59;16;189;1;90;24;51;2
GIPUZKOA;53;LEZO;1;1;B;907;551;5;546;5;541;356;64;44;191;2;104;37;99;0
GIPUZKOA;53;LEZO;1;2;A;898;461;6;455;8;447;437;51;23;213;0;54;40;66;0
GIPUZKOA;53;LEZO;1;2;B;815;423;0;423;6;417;392;51;28;187;0;48;40;62;1
GIPUZKOA;53;LEZO;1;3;U;1003;514;1;513;6;507;489;64;25;255;1;72;22;68;0
GIPUZKOA;54;LIZARTZA;1;1;U;580;449;3;446;4;442;131;60;14;257;0;110;1;0;0
GIPUZKOA;55;ARRASATE / MONDRAGON;1;1;A;705;462;7;455;6;449;243;127;40;117;0;107;21;37;0
GIPUZKOA;55;ARRASATE / MONDRAGON;1;1;B;547;359;3;356;4;352;188;96;33;111;0;63;22;27;0
GIPUZKOA;55;ARRASATE / MONDRAGON;1;2;A;752;520;1;519;10;509;232;139;31;174;1;96;31;37;0
GIPUZKOA;55;ARRASATE / MONDRAGON;1;2;B;594;398;1;397;6;391;196;134;28;114;0;60;17;38;0
GIPUZKOA;55;ARRASATE / MONDRAGON;1;3;U;766;518;3;515;4;511;248;144;38;159;0;109;16;45;0
GIPUZKOA;55;ARRASATE / MONDRAGON;1;4;U;970;594;2;592;9;583;376;137;32;133;1;106;64;108;2
GIPUZKOA;55;ARRASATE / MONDRAGON;1;5;A;834;579;7;572;5;567;255;173;46;125;0;150;26;47;0
GIPUZKOA;55;ARRASATE / MONDRAGON;1;5;B;638;419;2;417;14;403;219;135;40;101;0;84;14;29;0
GIPUZKOA;55;ARRASATE / MONDRAGON;2;1;U;821;546;2;544;5;539;275;115;36;174;3;68;48;94;1
GIPUZKOA;55;ARRASATE / MONDRAGON;2;2;A;696;427;2;425;6;419;269;57;38;97;2;41;66;118;0
GIPUZKOA;55;ARRASATE / MONDRAGON;2;2;B;664;397;1;396;12;384;267;38;31;82;0;37;50;146;0
GIPUZKOA;55;ARRASATE / MONDRAGON;2;3;A;616;335;8;327;3;324;281;39;28;34;0;16;58;147;2
GIPUZKOA;55;ARRASATE / MONDRAGON;2;3;B;640;348;3;345;9;336;292;31;38;43;5;21;58;139;1
GIPUZKOA;55;ARRASATE / MONDRAGON;2;4;A;844;570;4;566;8;558;274;103;32;184;2;117;44;75;1
GIPUZKOA;55;ARRASATE / MONDRAGON;2;4;B;742;443;2;441;3;438;299;81;34;161;1;61;27;73;0
GIPUZKOA;55;ARRASATE / MONDRAGON;3;1;A;581;349;3;346;3;343;232;81;35;64;3;39;42;79;0
GIPUZKOA;55;ARRASATE / MONDRAGON;3;1;B;605;375;6;369;1;368;230;80;46;73;4;32;35;96;2
GIPUZKOA;55;ARRASATE / MONDRAGON;3;2;A;650;400;3;397;6;391;250;78;23;109;0;77;23;80;1
GIPUZKOA;55;ARRASATE / MONDRAGON;3;2;B;542;310;2;308;3;305;232;74;32;74;0;39;15;71;0
GIPUZKOA;55;ARRASATE / MONDRAGON;3;3;A;676;374;8;366;9;357;302;52;29;92;1;51;32;99;1
GIPUZKOA;55;ARRASATE / MONDRAGON;3;3;B;544;327;5;322;6;316;217;47;17;76;2;48;21;105;0
GIPUZKOA;55;ARRASATE / MONDRAGON;4;1;A;595;341;0;341;6;335;254;62;21;87;1;39;47;78;0
GIPUZKOA;55;ARRASATE / MONDRAGON;4;1;B;600;353;1;352;7;345;247;58;25;93;0;30;42;95;2
GIPUZKOA;55;ARRASATE / MONDRAGON;4;2;A;614;384;0;384;7;377;230;88;21;115;3;54;22;74;0
GIPUZKOA;55;ARRASATE / MONDRAGON;4;2;B;477;295;1;294;2;292;182;71;33;69;2;47;24;45;1
GIPUZKOA;55;ARRASATE / MONDRAGON;4;3;A;664;355;1;354;8;346;309;63;43;70;1;28;26;114;1
GIPUZKOA;55;ARRASATE / MONDRAGON;4;3;B;585;351;5;346;5;341;234;65;27;56;2;23;42;124;2
GIPUZKOA;55;ARRASATE / MONDRAGON;4;4;A;667;463;1;462;9;453;204;138;12;161;0;90;18;34;0
GIPUZKOA;55;ARRASATE / MONDRAGON;4;4;B;576;365;2;363;9;354;211;103;15;135;1;57;16;27;0
GIPUZKOA;55;ARRASATE / MONDRAGON;5;1;U;1161;360;2;358;3;355;801;111;45;118;1;59;5;15;1
GIPUZKOA;56;MUTRIKU;1;1;A;794;560;18;542;7;535;234;225;34;214;0;42;6;14;0
GIPUZKOA;56;MUTRIKU;1;1;B;930;649;9;640;5;635;281;287;35;203;4;61;14;30;1
GIPUZKOA;56;MUTRIKU;1;2;A;788;581;5;576;5;571;207;296;41;195;0;29;4;6;0
GIPUZKOA;56;MUTRIKU;1;2;B;776;567;3;564;5;559;209;266;48;175;0;40;6;24;0
GIPUZKOA;56;MUTRIKU;2;1;U;537;341;4;337;8;329;196;197;7;81;0;39;2;3;0
GIPUZKOA;57;MUTILOA;1;1;U;149;86;1;85;1;84;63;24;6;27;0;24;2;1;0
GIPUZKOA;58;OLABERRIA;1;1;A;460;245;0;245;2;243;215;63;25;50;1;39;19;46;0
GIPUZKOA;58;OLABERRIA;1;1;B;492;294;0;294;0;294;198;74;35;66;2;43;22;52;0
GIPUZKOA;59;O?ATI;1;1;A;805;551;1;550;4;546;254;235;40;147;0;97;8;19;0
GIPUZKOA;59;O?ATI;1;1;B;667;425;2;423;2;421;242;169;38;125;1;58;8;22;0
GIPUZKOA;59;O?ATI;1;2;A;526;356;6;350;2;348;170;133;31;99;0;70;5;10;0
GIPUZKOA;59;O?ATI;1;2;B;469;319;3;316;3;313;150;133;28;59;1;57;6;28;1
GIPUZKOA;59;O?ATI;1;3;A;717;454;1;453;6;447;263;196;14;125;0;66;15;30;1
GIPUZKOA;59;O?ATI;1;3;B;644;409;0;409;6;403;235;158;17;113;1;73;11;30;0
GIPUZKOA;59;O?ATI;1;4;A;661;420;1;419;2;417;241;150;30;114;0;60;17;46;0
GIPUZKOA;59;O?ATI;1;4;B;517;317;2;315;5;310;200;97;31;86;0;51;11;34;0
GIPUZKOA;59;O?ATI;1;5;A;598;387;2;385;1;384;211;165;30;71;2;82;12;21;1
GIPUZKOA;59;O?ATI;1;5;B;405;255;0;255;4;251;150;110;10;57;0;40;13;21;0
GIPUZKOA;59;O?ATI;1;6;A;604;348;1;347;8;339;256;118;12;113;0;42;16;38;0
GIPUZKOA;59;O?ATI;1;6;B;469;268;1;267;3;264;201;69;11;98;0;41;19;26;0
GIPUZKOA;59;O?ATI;2;1;U;667;425;2;423;4;419;242;187;12;137;2;74;4;3;0
GIPUZKOA;59;O?ATI;2;2;U;847;484;2;482;4;478;363;217;24;141;1;81;4;10;0
GIPUZKOA;60;OREXA;1;1;U;71;59;0;59;0;59;12;5;0;52;0;1;0;0;1
GIPUZKOA;61;ORIO;1;1;A;877;508;2;506;7;499;369;224;29;120;0;87;13;26;0
GIPUZKOA;61;ORIO;1;1;B;799;462;3;459;3;456;337;169;28;134;1;81;7;35;1
GIPUZKOA;61;ORIO;1;2;A;940;569;4;565;5;560;371;199;25;158;1;103;18;56;0
GIPUZKOA;61;ORIO;1;2;B;781;456;0;456;7;449;325;165;23;122;1;86;10;42;0
GIPUZKOA;62;ORMAIZTEGI;1;1;A;528;391;15;376;5;371;137;165;3;110;1;80;5;6;1
GIPUZKOA;62;ORMAIZTEGI;1;1;B;422;315;9;306;6;300;107;120;12;76;0;85;5;2;0
GIPUZKOA;63;OIARTZUN;1;1;A;850;573;4;569;7;562;277;135;27;227;2;152;13;6;0
GIPUZKOA;63;OIARTZUN;1;1;B;852;585;2;583;13;570;267;109;31;270;1;130;18;11;0
GIPUZKOA;63;OIARTZUN;1;2;U;752;502;15;487;1;486;250;77;15;262;0;122;2;8;0
GIPUZKOA;63;OIARTZUN;1;3;U;1086;621;7;614;12;602;465;96;60;248;1;97;33;67;0
GIPUZKOA;63;OIARTZUN;1;4;A;640;384;4;380;5;375;256;75;14;171;0;80;16;18;1
GIPUZKOA;63;OIARTZUN;1;4;B;651;416;3;413;8;405;235;78;18;185;1;81;10;31;1
GIPUZKOA;63;OIARTZUN;1;5;U;992;639;2;637;9;628;353;130;16;355;0;116;8;2;1
GIPUZKOA;63;OIARTZUN;1;6;U;1063;676;9;667;13;654;387;143;11;319;0;135;17;28;1
GIPUZKOA;64;PASAIA;1;1;U;894;530;1;529;7;522;364;72;17;261;0;150;7;15;0
GIPUZKOA;64;PASAIA;1;2;A;695;362;0;362;2;360;333;61;29;147;0;80;17;26;0
GIPUZKOA;64;PASAIA;1;2;B;761;417;1;416;2;414;344;63;25;180;1;79;22;44;0
GIPUZKOA;64;PASAIA;2;1;A;476;266;2;264;4;260;210;44;10;83;0;106;5;12;0
GIPUZKOA;64;PASAIA;2;1;B;310;184;0;184;5;179;126;30;10;68;0;48;5;16;2
GIPUZKOA;64;PASAIA;2;2;U;678;340;2;338;6;332;338;43;22;104;0;26;36;101;0
GIPUZKOA;64;PASAIA;2;3;U;772;318;1;317;8;309;454;57;32;63;3;27;49;76;2
GIPUZKOA;64;PASAIA;2;4;A;405;184;0;184;7;177;221;29;17;36;0;24;21;47;3
GIPUZKOA;64;PASAIA;2;4;B;424;212;0;212;7;205;212;40;24;41;1;23;33;43;0
GIPUZKOA;64;PASAIA;2;5;U;1275;625;6;619;15;604;650;77;58;152;3;107;59;148;0
GIPUZKOA;64;PASAIA;2;6;U;800;359;1;358;6;352;441;63;37;76;1;29;52;94;0
GIPUZKOA;64;PASAIA;2;7;A;701;326;1;325;15;310;375;34;38;51;5;23;59;98;2
GIPUZKOA;64;PASAIA;2;7;B;764;357;0;357;6;351;407;44;60;59;0;21;48;118;1
GIPUZKOA;64;PASAIA;2;8;A;575;261;3;258;9;249;314;28;42;62;0;23;43;50;1
GIPUZKOA;64;PASAIA;2;8;B;746;332;2;330;9;321;414;36;49;62;1;37;45;91;0
GIPUZKOA;64;PASAIA;2;9;U;725;390;3;387;15;372;335;55;32;122;1;48;33;81;0
GIPUZKOA;64;PASAIA;3;1;A;715;371;4;367;7;360;344;79;20;115;0;58;25;63;0
GIPUZKOA;64;PASAIA;3;1;B;746;394;2;392;5;387;352;82;28;112;1;82;30;52;0
GIPUZKOA;64;PASAIA;3;2;A;848;485;8;477;12;465;363;90;42;126;0;101;39;66;1
GIPUZKOA;64;PASAIA;3;2;B;770;441;5;436;5;431;329;80;31;131;2;69;35;81;2
GIPUZKOA;64;PASAIA;3;3;A;598;322;4;318;4;314;276;55;35;99;0;49;31;44;1
GIPUZKOA;64;PASAIA;3;3;B;541;300;1;299;7;292;241;61;20;80;2;28;31;70;0
GIPUZKOA;65;SORALUZE-PLACENCIA DE LAS ARMAS;1;1;A;667;441;5;436;1;435;226;151;43;112;0;64;14;51;0
GIPUZKOA;65;SORALUZE-PLACENCIA DE LAS ARMAS;1;1;B;537;329;7;322;7;315;208;100;34;85;0;44;16;36;0
GIPUZKOA;65;SORALUZE-PLACENCIA DE LAS ARMAS;1;2;A;752;510;4;506;5;501;242;198;47;114;0;50;13;79;0
GIPUZKOA;65;SORALUZE-PLACENCIA DE LAS ARMAS;1;2;B;535;337;6;331;10;321;198;106;33;70;0;30;11;71;0
GIPUZKOA;65;SORALUZE-PLACENCIA DE LAS ARMAS;2;1;A;705;452;2;450;8;442;253;153;41;122;0;48;23;55;0
GIPUZKOA;65;SORALUZE-PLACENCIA DE LAS ARMAS;2;1;B;656;380;0;380;7;373;276;101;33;85;3;48;19;84;0
GIPUZKOA;66;ERREZIL;1;1;U;544;305;0;305;1;304;239;87;4;158;0;52;1;2;0
GIPUZKOA;67;ERRENTERIA;1;1;U;580;300;1;299;4;295;280;40;20;126;0;60;18;30;1
GIPUZKOA;67;ERRENTERIA;1;2;A;785;448;4;444;8;436;337;60;43;149;1;63;42;78;0
GIPUZKOA;67;ERRENTERIA;1;2;B;723;397;5;392;5;387;326;51;42;113;4;66;45;66;0
GIPUZKOA;67;ERRENTERIA;1;3;U;676;406;4;402;13;389;270;67;37;143;2;78;28;34;0
GIPUZKOA;67;ERRENTERIA;1;4;A;871;482;2;480;9;471;389;61;39;118;0;54;75;123;1
GIPUZKOA;67;ERRENTERIA;1;4;B;661;375;2;373;3;370;286;44;37;82;1;48;63;94;1
GIPUZKOA;67;ERRENTERIA;1;5;U;738;446;6;440;5;435;292;88;27;205;0;50;26;39;0
GIPUZKOA;67;ERRENTERIA;1;6;A;942;555;3;552;10;542;387;84;38;169;0;98;50;103;0
GIPUZKOA;67;ERRENTERIA;1;6;B;782;476;0;476;13;463;306;70;50;140;1;80;43;79;0
GIPUZKOA;67;ERRENTERIA;1;7;U;595;344;0;344;6;338;251;49;34;119;0;36;28;71;1
GIPUZKOA;67;ERRENTERIA;1;8;A;532;267;2;265;10;255;265;32;17;62;0;29;33;82;0
GIPUZKOA;67;ERRENTERIA;1;8;B;507;287;0;287;6;281;220;30;30;61;0;26;24;109;1
GIPUZKOA;67;ERRENTERIA;1;9;A;758;410;6;404;2;402;348;64;30;130;1;67;30;80;0
GIPUZKOA;67;ERRENTERIA;1;9;B;727;401;2;399;5;394;326;60;40;150;0;56;20;68;0
GIPUZKOA;67;ERRENTERIA;1;10;U;743;442;1;441;5;436;301;58;34;152;1;46;26;119;0
GIPUZKOA;67;ERRENTERIA;1;11;U;639;372;1;371;8;363;267;53;28;110;2;30;55;85;0
GIPUZKOA;67;ERRENTERIA;1;12;U;533;297;4;293;4;289;236;52;28;77;0;40;18;73;1
GIPUZKOA;67;ERRENTERIA;1;13;A;524;283;5;278;4;274;241;34;32;82;0;36;30;59;1
GIPUZKOA;67;ERRENTERIA;1;13;B;523;253;2;251;3;248;270;29;33;58;0;29;31;68;0
GIPUZKOA;67;ERRENTERIA;1;14;A;680;350;0;350;4;346;330;59;57;67;0;44;34;83;2
GIPUZKOA;67;ERRENTERIA;1;14;B;632;354;0;354;5;349;278;51;52;74;3;48;26;95;0
GIPUZKOA;67;ERRENTERIA;1;15;U;663;347;0;347;8;339;316;30;25;81;1;33;35;133;1
GIPUZKOA;67;ERRENTERIA;1;16;U;797;390;3;387;14;373;407;46;48;42;6;17;44;168;2
GIPUZKOA;67;ERRENTERIA;1;17;U;641;336;0;336;8;328;305;64;12;106;0;51;18;77;0
GIPUZKOA;67;ERRENTERIA;1;18;U;534;297;2;295;2;293;237;63;12;153;0;52;5;7;1
GIPUZKOA;67;ERRENTERIA;1;19;A;602;323;3;320;12;308;279;35;35;55;2;23;61;96;1
GIPUZKOA;67;ERRENTERIA;1;19;B;619;323;4;319;5;314;296;31;43;54;1;28;57;100;0
GIPUZKOA;67;ERRENTERIA;1;20;U;1036;601;0;601;15;586;435;92;35;225;0;119;31;84;0
GIPUZKOA;67;ERRENTERIA;1;21;U;559;266;0;266;6;260;293;24;37;36;0;19;28;116;0
GIPUZKOA;67;ERRENTERIA;1;22;A;613;326;1;325;9;316;287;43;30;99;0;43;32;69;0
GIPUZKOA;67;ERRENTERIA;1;22;B;590;330;0;330;9;321;260;32;26;115;0;25;46;76;1
GIPUZKOA;67;ERRENTERIA;1;23;U;931;534;2;532;13;519;397;54;83;111;2;64;47;157;1
GIPUZKOA;67;ERRENTERIA;1;24;A;649;289;1;288;2;286;360;30;34;58;2;22;45;94;1
GIPUZKOA;67;ERRENTERIA;1;24;B;695;313;1;312;5;307;382;38;48;53;1;17;36;113;1
GIPUZKOA;67;ERRENTERIA;1;25;A;638;277;0;277;5;272;361;34;27;55;1;15;38;102;0
GIPUZKOA;67;ERRENTERIA;1;25;B;626;289;0;289;4;285;337;21;27;66;2;14;31;123;1
GIPUZKOA;67;ERRENTERIA;1;26;A;867;441;2;439;11;428;426;49;48;74;1;33;64;159;0
GIPUZKOA;67;ERRENTERIA;1;26;B;867;437;1;436;17;419;430;33;57;54;1;19;59;195;1
GIPUZKOA;67;ERRENTERIA;1;27;A;595;273;0;273;5;268;322;21;38;42;0;12;37;118;0
GIPUZKOA;67;ERRENTERIA;1;27;B;648;306;3;303;7;296;342;28;32;51;3;16;37;128;1
GIPUZKOA;67;ERRENTERIA;1;28;A;588;267;3;264;6;258;321;41;41;39;2;22;35;78;0
GIPUZKOA;67;ERRENTERIA;1;28;B;584;268;0;268;6;262;316;32;40;49;4;19;32;86;0
GIPUZKOA;67;ERRENTERIA;1;29;A;704;357;0;357;10;347;347;52;46;53;2;15;54;125;0
GIPUZKOA;67;ERRENTERIA;1;29;B;706;331;0;331;9;322;375;52;37;61;0;15;48;108;1
GIPUZKOA;67;ERRENTERIA;1;30;U;794;461;0;461;15;446;333;79;40;134;2;71;46;74;0
GIPUZKOA;67;ERRENTERIA;1;31;U;556;273;0;273;3;270;283;21;33;28;2;13;22;150;1
GIPUZKOA;67;ERRENTERIA;1;32;U;877;460;4;456;8;448;417;56;60;52;6;22;42;209;1
GIPUZKOA;67;ERRENTERIA;1;33;U;771;384;1;383;7;376;387;44;26;73;3;27;58;145;0
GIPUZKOA;67;ERRENTERIA;1;34;U;688;378;5;373;6;367;310;45;20;136;0;44;45;77;0
GIPUZKOA;67;ERRENTERIA;1;35;U;609;353;0;353;10;343;256;78;21;127;1;59;24;33;0
GIPUZKOA;68;LEINTZ-GATZAGA;1;1;U;202;138;0;138;2;136;64;56;0;60;0;18;2;0;0
GIPUZKOA;69;DONOSTIA-SAN SEBASTI?N;1;1;U;812;487;0;487;9;478;325;111;74;122;0;112;16;42;1
GIPUZKOA;69;DONOSTIA-SAN SEBASTI?N;1;2;U;854;526;0;526;8;518;328;112;76;114;0;150;26;39;1
GIPUZKOA;69;DONOSTIA-SAN SEBASTI?N;1;3;U;637;382;0;382;10;372;255;61;22;144;0;108;9;28;0
GIPUZKOA;69;DONOSTIA-SAN SEBASTI?N;1;4;U;881;518;0;518;5;513;363;95;35;193;1;117;22;50;0
GIPUZKOA;69;DONOSTIA-SAN SEBASTI?N;1;5;U;967;593;1;592;13;579;374;105;116;125;2;135;36;59;1
GIPUZKOA;69;DONOSTIA-SAN SEBASTI?N;1;6;A;611;373;9;364;0;364;238;91;53;66;0;97;11;46;0
GIPUZKOA;69;DONOSTIA-SAN SEBASTI?N;1;6;B;523;321;2;319;9;310;202;69;63;57;0;66;23;32;0
GIPUZKOA;69;DONOSTIA-SAN SEBASTI?N;1;7;U;752;444;9;435;4;431;308;93;56;102;0;121;21;38;0
GIPUZKOA;69;DONOSTIA-SAN SEBASTI?N;2;1;U;979;660;8;652;21;631;319;109;221;86;1;129;23;61;1
GIPUZKOA;69;DONOSTIA-SAN SEBASTI?N;2;2;U;693;477;6;471;10;461;216;104;186;40;0;73;20;38;0
GIPUZKOA;69;DONOSTIA-SAN SEBASTI?N;2;3;U;668;440;1;439;5;434;228;108;120;41;1;105;17;42;0
GIPUZKOA;69;DONOSTIA-SAN SEBASTI?N;2;4;A;554;363;5;358;7;351;191;84;114;26;1;80;11;34;1
GIPUZKOA;69;DONOSTIA-SAN SEBASTI?N;2;4;B;519;340;3;337;8;329;179;63;132;28;0;56;7;43;0
GIPUZKOA;69;DONOSTIA-SAN SEBASTI?N;2;5;U;918;604;1;603;22;581;314;147;162;64;1;118;29;59;1
GIPUZKOA;69;DONOSTIA-SAN SEBASTI?N;2;6;A;591;378;1;377;11;366;213;100;97;56;3;73;12;25;0
GIPUZKOA;69;DONOSTIA-SAN SEBASTI?N;2;6;B;475;305;0;305;10;295;170;64;100;31;0;58;12;30;0
GIPUZKOA;69;DONOSTIA-SAN SEBASTI?N;2;7;A;654;430;0;430;13;417;224;108;153;38;1;72;9;36;0
GIPUZKOA;69;DONOSTIA-SAN SEBASTI?N;2;7;B;559;373;0;373;10;363;186;84;165;19;1;47;15;32;0
GIPUZKOA;69;DONOSTIA-SAN SEBASTI?N;2;8;A;586;350;0;350;9;341;236;66;85;65;1;62;14;48;0
GIPUZKOA;69;DONOSTIA-SAN SEBASTI?N;2;8;B;454;275;3;272;2;270;179;61;76;33;1;46;19;34;0
GIPUZKOA;69;DONOSTIA-SAN SEBASTI?N;2;9;U;901;598;7;591;7;584;303;160;140;67;4;113;29;71;0
GIPUZKOA;69;DONOSTIA-SAN SEBASTI?N;3;1;U;890;586;5;581;18;563;304;127;191;60;2;102;29;52;0
GIPUZKOA;69;DONOSTIA-SAN SEBASTI?N;3;2;U;921;575;0;575;34;541;346;99;152;65;6;103;37;79;0
GIPUZKOA;69;DONOSTIA-SAN SEBASTI?N;3;3;U;953;607;2;605;19;586;346;79;130;124;7;116;41;89;0
GIPUZKOA;69;DONOSTIA-SAN SEBASTI?N;3;4;U;991;557;0;557;21;536;434;97;128;87;3;99;48;73;1
GIPUZKOA;69;DONOSTIA-SAN SEBASTI?N;3;5;A;710;381;1;380;11;369;329;50;62;90;1;54;33;79;0
GIPUZKOA;69;DONOSTIA-SAN SEBASTI?N;3;5;B;559;299;2;297;7;290;260;30;65;56;0;46;23;70;0
GIPUZKOA;69;DONOSTIA-SAN SEBASTI?N;3;6;A;482;282;1;281;12;269;200;44;25;75;0;41;21;62;1
GIPUZKOA;69;DONOSTIA-SAN SEBASTI?N;3;6;B;528;284;3;281;3;278;244;37;25;91;0;40;24;59;2
GIPUZKOA;69;DONOSTIA-SAN SEBASTI?N;3;7;U;827;498;1;497;8;489;329;98;95;63;0;101;36;96;0
GIPUZKOA;69;DONOSTIA-SAN SEBASTI?N;3;8;U;733;450;6;444;9;435;283;86;97;96;1;72;26;56;1
GIPUZKOA;69;DONOSTIA-SAN SEBASTI?N;3;9;A;615;397;2;395;8;387;218;70;156;37;1;65;19;39;0
GIPUZKOA;69;DONOSTIA-SAN SEBASTI?N;3;9;B;473;310;1;309;10;299;163;35;133;33;0;34;29;34;1
GIPUZKOA;69;DONOSTIA-SAN SEBASTI?N;3;10;A;599;393;1;392;9;383;206;71;153;31;0;59;20;49;0
GIPUZKOA;69;DONOSTIA-SAN SEBASTI?N;3;10;B;540;364;1;363;6;357;176;50;148;25;5;69;26;33;1
GIPUZKOA;69;DONOSTIA-SAN SEBASTI?N;3;11;A;753;477;2;475;15;460;276;85;169;56;0;57;28;64;1
GIPUZKOA;69;DONOSTIA-SAN SEBASTI?N;3;11;B;682;427;6;421;10;411;255;76;111;40;3;64;35;82;0
GIPUZKOA;69;DONOSTIA-SAN SEBASTI?N;3;12;A;738;503;1;502;21;481;235;98;222;18;2;60;24;57;0
GIPUZKOA;69;DONOSTIA-SAN SEBASTI?N;3;12;B;645;440;0;440;20;420;205;47;209;12;3;64;32;52;1
GIPUZKOA;69;DONOSTIA-SAN SEBASTI?N;3;13;A;679;405;3;402;14;388;274;59;101;60;1;69;46;52;0
GIPUZKOA;69;DONOSTIA-SAN SEBASTI?N;3;13;B;568;331;3;328;13;315;237;46;70;53;0;56;36;53;1
GIPUZKOA;69;DONOSTIA-SAN SEBASTI?N;3;14;A;532;281;5;276;5;271;251;45;58;55;1;45;17;49;1
GIPUZKOA;69;DONOSTIA-SAN SEBASTI?N;3;14;B;560;298;0;298;6;292;262;43;48;45;1;53;27;75;0
GIPUZKOA;69;DONOSTIA-SAN SEBASTI?N;3;14;U;920;517;13;504;0;504;403;86;123;76;0;88;44;86;1
GIPUZKOA;69;DONOSTIA-SAN SEBASTI?N;3;15;A;623;381;3;378;25;353;242;79;107;25;1;54;20;67;0
GIPUZKOA;69;DONOSTIA-SAN SEBASTI?N;3;15;B;554;358;0;358;17;341;196;54;106;31;3;75;21;51;0
GIPUZKOA;69;DONOSTIA-SAN SEBASTI?N;3;15;U;840;500;0;500;21;479;340;96;139;45;2;96;42;59;0
GIPUZKOA;69;DONOSTIA-SAN SEBASTI?N;3;16;A;574;389;0;389;15;374;185;91;100;61;2;47;24;47;2
GIPUZKOA;69;DONOSTIA-SAN SEBASTI?N;3;16;B;464;315;1;314;8;306;149;67;109;25;1;42;22;40;0
GIPUZKOA;69;DONOSTIA-SAN SEBASTI?N;3;17;A;830;535;1;534;13;521;295;122;133;66;0;96;39;65;0
GIPUZKOA;69;DONOSTIA-SAN SEBASTI?N;3;17;B;811;526;2;524;19;505;285;88;151;61;2;90;37;76;0
GIPUZKOA;69;DONOSTIA-SAN SEBASTI?N;3;18;A;942;514;0;514;19;495;428;105;114;59;2;110;44;61;0
GIPUZKOA;69;DONOSTIA-SAN SEBASTI?N;3;18;B;811;463;2;461;13;448;348;91;126;51;1;80;46;52;1
GIPUZKOA;69;DONOSTIA-SAN SEBASTI?N;3;19;U;950;540;0;540;8;532;410;83;132;69;3;92;44;109;0
GIPUZKOA;69;DONOSTIA-SAN SEBASTI?N;3;20;A;756;396;2;394;13;381;360;75;54;66;1;86;27;72;0
GIPUZKOA;69;DONOSTIA-SAN SEBASTI?N;3;20;B;625;298;0;298;10;288;327;56;35;45;0;47;31;74;0
GIPUZKOA;69;DONOSTIA-SAN SEBASTI?N;3;21;A;899;481;5;476;14;462;418;51;69;102;3;89;39;109;0
GIPUZKOA;69;DONOSTIA-SAN SEBASTI?N;3;21;B;841;423;5;418;15;403;418;47;66;78;1;66;44;99;2
GIPUZKOA;69;DONOSTIA-SAN SEBASTI?N;3;22;U;673;350;6;344;10;334;323;49;47;86;0;44;42;58;8
GIPUZKOA;69;DONOSTIA-SAN SEBASTI?N;3;23;U;623;295;2;293;7;286;328;51;35;44;0;55;26;75;0
GIPUZKOA;69;DONOSTIA-SAN SEBASTI?N;3;24;A;751;473;5;468;10;458;278;132;122;22;2;73;35;72;0
GIPUZKOA;69;DONOSTIA-SAN SEBASTI?N;3;24;B;591;401;2;399;16;383;190;92;106;37;2;60;31;55;0
GIPUZKOA;69;DONOSTIA-SAN SEBASTI?N;3;25;A;929;596;4;592;21;571;333;140;147;61;3;96;44;79;1
GIPUZKOA;69;DONOSTIA-SAN SEBASTI?N;3;25;B;768;485;0;485;11;474;283;101;125;44;4;85;38;77;0
GIPUZKOA;69;DONOSTIA-SAN SEBASTI?N;3;26;A;574;385;0;385;11;374;189;92;88;40;2;70;23;59;0
GIPUZKOA;69;DONOSTIA-SAN SEBASTI?N;3;26;B;521;327;0;327;14;313;194;65;85;38;0;52;22;51;0
GIPUZKOA;69;DONOSTIA-SAN SEBASTI?N;3;27;A;789;491;1;490;14;476;298;85;108;59;3;105;47;69;0
GIPUZKOA;69;DONOSTIA-SAN SEBASTI?N;3;27;B;681;442;2;440;18;422;239;70;109;41;1;73;59;68;1
GIPUZKOA;69;DONOSTIA-SAN SEBASTI?N;4;1;A;621;398;3;395;11;384;223;92;104;55;1;59;23;50;0
GIPUZKOA;69;DONOSTIA-SAN SEBASTI?N;4;1;B;511;295;2;293;13;280;216;40;105;36;0;45;14;40;0
GIPUZKOA;69;DONOSTIA-SAN SEBASTI?N;4;2;A;537;349;1;348;16;332;188;64;114;43;0;62;17;31;1
GIPUZKOA;69;DONOSTIA-SAN SEBASTI?N;4;2;B;526;313;0;313;9;304;213;49;99;33;0;45;29;49;0
GIPUZKOA;69;DONOSTIA-SAN SEBASTI?N;4;3;A;634;403;1;402;15;387;231;78;96;49;1;81;25;56;1
GIPUZKOA;69;DONOSTIA-SAN SEBASTI?N;4;3;B;504;336;0;336;9;327;168;49;93;55;0;56;20;54;0
GIPUZKOA;69;DONOSTIA-SAN SEBASTI?N;4;4;A;593;376;3;373;21;352;217;74;118;37;1;64;21;36;1
GIPUZKOA;69;DONOSTIA-SAN SEBASTI?N;4;4;B;512;358;5;353;7;346;154;63;105;31;3;72;31;41;0
GIPUZKOA;69;DONOSTIA-SAN SEBASTI?N;4;5;U;740;472;1;471;18;453;268;79;137;62;0;91;19;65;0
GIPUZKOA;69;DONOSTIA-SAN SEBASTI?N;4;6;U;956;594;4;590;16;574;362;108;151;89;0;101;49;76;0
GIPUZKOA;69;DONOSTIA-SAN SEBASTI?N;4;7;A;925;488;1;487;19;468;437;84;105;87;3;74;36;78;1
GIPUZKOA;69;DONOSTIA-SAN SEBASTI?N;4;7;B;790;450;1;449;8;441;340;82;70;95;2;69;41;82;0
GIPUZKOA;69;DONOSTIA-SAN SEBASTI?N;4;8;A;923;419;0;419;6;413;504;44;40;128;2;67;47;85;0
GIPUZKOA;69;DONOSTIA-SAN SEBASTI?N;4;8;B;968;466;1;465;8;457;502;40;62;133;2;65;64;90;1
GIPUZKOA;69;DONOSTIA-SAN SEBASTI?N;4;9;A;576;298;0;298;5;293;278;34;47;76;3;46;40;47;0
GIPUZKOA;69;DONOSTIA-SAN SEBASTI?N;4;9;B;536;297;0;297;2;295;239;41;50;72;3;27;41;61;0
GIPUZKOA;69;DONOSTIA-SAN SEBASTI?N;4;10;A;511;317;4;313;11;302;194;54;70;54;3;45;19;57;0
GIPUZKOA;69;DONOSTIA-SAN SEBASTI?N;4;10;B;464;280;0;280;4;276;184;58;57;43;0;42;25;50;1
GIPUZKOA;69;DONOSTIA-SAN SEBASTI?N;4;11;U;993;538;2;536;8;528;455;78;63;131;1;83;64;105;3
GIPUZKOA;69;DONOSTIA-SAN SEBASTI?N;4;12;A;772;468;5;463;12;451;304;75;57;109;2;84;32;92;0
GIPUZKOA;69;DONOSTIA-SAN SEBASTI?N;4;12;B;742;433;3;430;7;423;309;63;58;97;0;55;31;119;0
GIPUZKOA;69;DONOSTIA-SAN SEBASTI?N;4;13;U;983;533;0;533;13;520;450;39;96;153;2;68;52;108;2
GIPUZKOA;69;DONOSTIA-SAN SEBASTI?N;4;14;A;653;344;8;336;10;326;309;49;53;74;1;45;31;73;0
GIPUZKOA;69;DONOSTIA-SAN SEBASTI?N;4;14;B;602;301;0;301;5;296;301;40;61;65;0;44;21;65;0
GIPUZKOA;69;DONOSTIA-SAN SEBASTI?N;4;15;A;699;378;2;376;8;368;321;57;56;80;0;68;28;78;1
GIPUZKOA;69;DONOSTIA-SAN SEBASTI?N;4;15;B;655;346;0;346;9;337;309;45;40;71;1;61;41;77;1
GIPUZKOA;69;DONOSTIA-SAN SEBASTI?N;4;16;U;972;495;2;493;9;484;477;51;68;143;2;58;40;122;0
GIPUZKOA;69;DONOSTIA-SAN SEBASTI?N;4;17;A;737;393;2;391;3;388;344;64;70;92;1;65;25;71;0
GIPUZKOA;69;DONOSTIA-SAN SEBASTI?N;4;17;B;693;360;2;358;5;353;333;39;73;82;0;42;36;80;1
GIPUZKOA;69;DONOSTIA-SAN SEBASTI?N;4;18;A;593;324;1;323;5;318;269;47;53;69;1;42;39;67;0
GIPUZKOA;69;DONOSTIA-SAN SEBASTI?N;4;18;B;717;404;0;404;8;396;313;45;64;89;2;45;56;95;0
GIPUZKOA;69;DONOSTIA-SAN SEBASTI?N;4;19;U;945;514;6;508;9;499;431;69;97;121;0;78;55;79;0
GIPUZKOA;69;DONOSTIA-SAN SEBASTI?N;5;1;A;625;373;2;371;14;357;252;76;87;51;0;79;15;49;0
GIPUZKOA;69;DONOSTIA-SAN SEBASTI?N;5;1;B;602;375;0;375;12;363;227;67;76;45;3;81;34;56;1
GIPUZKOA;69;DONOSTIA-SAN SEBASTI?N;5;2;A;781;446;4;442;17;425;335;77;54;88;0;97;40;69;0
GIPUZKOA;69;DONOSTIA-SAN SEBASTI?N;5;2;B;691;412;0;412;11;401;279;67;67;88;0;77;28;74;0
GIPUZKOA;69;DONOSTIA-SAN SEBASTI?N;5;3;A;575;336;4;332;14;318;239;70;59;42;0;69;24;54;0
GIPUZKOA;69;DONOSTIA-SAN SEBASTI?N;5;3;B;486;296;0;296;13;283;190;62;61;47;1;44;23;45;0
GIPUZKOA;69;DONOSTIA-SAN SEBASTI?N;5;4;U;1009;572;0;572;13;559;437;80;113;114;0;113;43;96;0
GIPUZKOA;69;DONOSTIA-SAN SEBASTI?N;5;5;U;1023;548;1;547;15;532;475;143;99;74;0;108;35;72;1
GIPUZKOA;69;DONOSTIA-SAN SEBASTI?N;5;6;U;992;587;5;582;10;572;405;89;80;137;1;124;57;84;0
GIPUZKOA;69;DONOSTIA-SAN SEBASTI?N;5;7;U;896;475;2;473;18;455;421;62;44;169;0;53;48;79;0
GIPUZKOA;69;DONOSTIA-SAN SEBASTI?N;5;8;A;893;547;5;542;23;519;346;114;104;84;0;109;40;68;0
GIPUZKOA;69;DONOSTIA-SAN SEBASTI?N;5;8;B;832;510;1;509;15;494;322;68;127;86;1;103;48;61;0
GIPUZKOA;69;DONOSTIA-SAN SEBASTI?N;5;9;A;639;381;0;381;14;367;258;92;77;57;0;74;21;46;0
GIPUZKOA;69;DONOSTIA-SAN SEBASTI?N;5;9;B;526;316;2;314;10;304;210;73;71;34;0;52;29;45;0
GIPUZKOA;69;DONOSTIA-SAN SEBASTI?N;5;10;A;592;363;1;362;19;343;229;77;69;63;0;64;33;37;0
GIPUZKOA;69;DONOSTIA-SAN SEBASTI?N;5;10;B;500;310;3;307;12;295;190;53;43;59;1;59;24;56;0
GIPUZKOA;69;DONOSTIA-SAN SEBASTI?N;5;11;U;735;443;3;440;19;421;292;91;93;68;0;77;23;69;0
GIPUZKOA;69;DONOSTIA-SAN SEBASTI?N;5;12;A;709;446;4;442;12;430;263;88;145;51;1;77;30;38;0
GIPUZKOA;69;DONOSTIA-SAN SEBASTI?N;5;12;B;654;406;0;406;19;387;248;62;154;41;1;65;24;40;0
GIPUZKOA;69;DONOSTIA-SAN SEBASTI?N;5;13;A;615;333;1;332;17;315;282;68;62;73;0;44;38;30;0
GIPUZKOA;69;DONOSTIA-SAN SEBASTI?N;5;13;B;552;309;0;309;13;296;243;49;67;71;1;51;17;40;0
GIPUZKOA;69;DONOSTIA-SAN SEBASTI?N;5;14;A;733;423;1;422;12;410;310;72;82;95;1;96;23;41;0
GIPUZKOA;69;DONOSTIA-SAN SEBASTI?N;5;14;B;605;343;1;342;6;336;262;44;87;92;1;68;18;26;0
GIPUZKOA;69;DONOSTIA-SAN SEBASTI?N;6;1;U;1031;692;1;691;28;663;339;206;268;25;2;119;16;26;1
GIPUZKOA;69;DONOSTIA-SAN SEBASTI?N;6;2;A;802;489;4;485;16;469;313;114;104;73;0;106;23;49;0
GIPUZKOA;69;DONOSTIA-SAN SEBASTI?N;6;2;B;641;394;0;394;16;378;247;76;117;26;1;80;20;58;0
GIPUZKOA;69;DONOSTIA-SAN SEBASTI?N;6;3;A;802;463;1;462;19;443;339;87;66;116;4;84;38;48;0
GIPUZKOA;69;DONOSTIA-SAN SEBASTI?N;6;3;B;775;403;13;390;1;389;372;90;63;67;0;86;22;61;0
GIPUZKOA;69;DONOSTIA-SAN SEBASTI?N;6;4;A;906;467;3;464;13;451;439;93;58;137;2;85;23;53;0
GIPUZKOA;69;DONOSTIA-SAN SEBASTI?N;6;4;B;847;450;3;447;9;438;397;103;64;101;0;86;21;62;1
GIPUZKOA;69;DONOSTIA-SAN SEBASTI?N;6;5;A;831;525;2;523;21;502;306;111;82;94;0;105;31;78;1
GIPUZKOA;69;DONOSTIA-SAN SEBASTI?N;6;5;B;853;535;0;535;13;522;318;110;98;118;0;106;29;61;0
GIPUZKOA;69;DONOSTIA-SAN SEBASTI?N;6;6;A;564;312;2;310;11;299;252;88;60;69;0;48;12;22;0
GIPUZKOA;69;DONOSTIA-SAN SEBASTI?N;6;6;B;503;283;2;281;3;278;220;64;63;59;0;51;14;27;0
GIPUZKOA;69;DONOSTIA-SAN SEBASTI?N;6;7;A;741;469;8;461;14;447;272;125;151;36;0;89;20;26;0
GIPUZKOA;69;DONOSTIA-SAN SEBASTI?N;6;7;B;653;406;0;406;6;400;247;67;177;33;2;78;18;25;0
GIPUZKOA;69;DONOSTIA-SAN SEBASTI?N;6;8;U;931;503;0;503;25;478;428;91;129;68;0;76;40;74;0
GIPUZKOA;69;DONOSTIA-SAN SEBASTI?N;6;9;U;637;324;2;322;9;313;313;51;62;74;0;73;22;31;0
GIPUZKOA;69;DONOSTIA-SAN SEBASTI?N;6;10;U;937;528;1;527;5;522;409;114;54;113;3;116;37;85;0
GIPUZKOA;69;DONOSTIA-SAN SEBASTI?N;6;11;A;559;373;2;371;30;341;186;66;140;29;0;63;11;32;0
GIPUZKOA;69;DONOSTIA-SAN SEBASTI?N;6;11;B;573;365;0;365;23;342;208;78;107;25;1;63;23;45;0
GIPUZKOA;69;DONOSTIA-SAN SEBASTI?N;6;12;A;823;470;1;469;16;453;353;77;33;165;0;112;23;43;0
GIPUZKOA;69;DONOSTIA-SAN SEBASTI?N;6;12;B;673;374;2;372;11;361;299;54;38;99;3;103;35;28;1
GIPUZKOA;69;DONOSTIA-SAN SEBASTI?N;6;13;A;792;468;4;464;8;456;324;85;36;152;0;112;36;35;0
GIPUZKOA;69;DONOSTIA-SAN SEBASTI?N;6;13;B;693;428;4;424;14;410;265;61;26;130;0;106;33;54;0
GIPUZKOA;69;DONOSTIA-SAN SEBASTI?N;6;14;U;978;608;3;605;26;579;370;129;174;77;0;110;34;55;0
GIPUZKOA;69;DONOSTIA-SAN SEBASTI?N;6;15;U;909;619;0;619;20;599;290;135;116;173;1;134;18;22;0
GIPUZKOA;69;DONOSTIA-SAN SEBASTI?N;6;16;U;579;352;2;350;14;336;227;102;64;44;0;78;20;28;0
GIPUZKOA;69;DONOSTIA-SAN SEBASTI?N;6;17;A;733;443;2;441;19;422;290;97;102;55;0;92;32;44;0
GIPUZKOA;69;DONOSTIA-SAN SEBASTI?N;6;17;B;649;383;1;382;17;365;266;84;97;36;0;79;22;47;0
GIPUZKOA;69;DONOSTIA-SAN SEBASTI?N;6;18;A;679;437;1;436;20;416;242;141;98;36;2;84;19;34;2
GIPUZKOA;69;DONOSTIA-SAN SEBASTI?N;6;18;B;548;365;3;362;15;347;183;113;96;28;1;63;16;28;2
GIPUZKOA;69;DONOSTIA-SAN SEBASTI?N;6;19;A;581;354;1;353;16;337;227;62;44;64;0;54;45;68;0
GIPUZKOA;69;DONOSTIA-SAN SEBASTI?N;6;19;B;548;325;0;325;12;313;223;48;52;53;1;55;38;66;0
GIPUZKOA;69;DONOSTIA-SAN SEBASTI?N;6;20;A;937;596;7;589;11;578;341;150;142;71;4;111;39;61;0
GIPUZKOA;69;DONOSTIA-SAN SEBASTI?N;6;20;B;828;559;0;559;17;542;269;105;152;61;5;121;26;72;0
GIPUZKOA;69;DONOSTIA-SAN SEBASTI?N;7;1;A;705;376;0;376;9;367;329;65;28;48;0;33;51;141;1
GIPUZKOA;69;DONOSTIA-SAN SEBASTI?N;7;1;B;748;386;0;386;12;374;362;47;46;60;4;25;45;147;0
GIPUZKOA;69;DONOSTIA-SAN SEBASTI?N;7;2;A;744;378;0;378;10;368;366;45;62;43;3;32;46;136;1
GIPUZKOA;69;DONOSTIA-SAN SEBASTI?N;7;2;B;782;406;3;403;12;391;376;53;51;53;1;19;46;166;2
GIPUZKOA;69;DONOSTIA-SAN SEBASTI?N;7;3;A;588;354;2;352;6;346;234;64;74;62;2;78;35;31;0
GIPUZKOA;69;DONOSTIA-SAN SEBASTI?N;7;3;B;596;339;0;339;6;333;257;57;99;58;3;54;26;35;1
GIPUZKOA;69;DONOSTIA-SAN SEBASTI?N;7;4;A;539;297;1;296;5;291;242;42;35;80;1;45;28;60;0
GIPUZKOA;69;DONOSTIA-SAN SEBASTI?N;7;4;B;505;245;0;245;6;239;260;37;42;41;0;23;23;73;0
GIPUZKOA;69;DONOSTIA-SAN SEBASTI?N;7;5;A;747;418;7;411;14;397;329;59;36;105;0;51;42;104;0
GIPUZKOA;69;DONOSTIA-SAN SEBASTI?N;7;5;B;644;376;1;375;19;356;268;40;40;91;1;31;35;118;0
GIPUZKOA;69;DONOSTIA-SAN SEBASTI?N;7;6;A;635;348;1;347;17;330;287;62;44;67;0;61;40;56;0
GIPUZKOA;69;DONOSTIA-SAN SEBASTI?N;7;6;B;613;326;2;324;12;312;287;53;43;75;0;54;39;48;0
GIPUZKOA;69;DONOSTIA-SAN SEBASTI?N;7;7;A;725;320;1;319;10;309;405;20;79;52;3;39;37;77;2
GIPUZKOA;69;DONOSTIA-SAN SEBASTI?N;7;7;B;737;331;4;327;6;321;406;19;88;77;0;20;36;79;2
GIPUZKOA;69;DONOSTIA-SAN SEBASTI?N;7;8;U;843;458;1;457;11;446;385;60;57;141;1;107;28;51;1
GIPUZKOA;69;DONOSTIA-SAN SEBASTI?N;7;9;U;822;396;4;392;6;386;426;58;49;105;2;71;21;79;1
GIPUZKOA;69;DONOSTIA-SAN SEBASTI?N;7;10;A;547;354;2;352;10;342;193;69;93;45;5;70;17;43;0
GIPUZKOA;69;DONOSTIA-SAN SEBASTI?N;7;10;B;638;405;0;405;26;379;233;68;111;45;7;72;31;43;2
GIPUZKOA;69;DONOSTIA-SAN SEBASTI?N;7;11;A;676;336;1;335;3;332;340;31;40;96;2;20;58;82;3
GIPUZKOA;69;DONOSTIA-SAN SEBASTI?N;7;11;B;688;332;0;332;3;329;356;31;31;84;2;26;44;111;0
GIPUZKOA;69;DONOSTIA-SAN SEBASTI?N;7;12;A;528;277;1;276;7;269;251;38;36;69;0;25;29;72;0
GIPUZKOA;69;DONOSTIA-SAN SEBASTI?N;7;12;B;577;274;0;274;6;268;303;34;44;68;1;15;27;77;2
GIPUZKOA;69;DONOSTIA-SAN SEBASTI?N;7;13;U;989;528;1;527;17;510;461;60;105;82;0;63;77;121;2
GIPUZKOA;69;DONOSTIA-SAN SEBASTI?N;7;14;A;609;255;2;253;6;247;354;31;28;46;0;39;30;73;0
GIPUZKOA;69;DONOSTIA-SAN SEBASTI?N;7;14;B;717;309;1;308;5;303;408;34;43;71;1;25;38;90;1
GIPUZKOA;69;DONOSTIA-SAN SEBASTI?N;7;15;A;606;348;0;348;12;336;258;40;53;81;1;41;39;81;0
GIPUZKOA;69;DONOSTIA-SAN SEBASTI?N;7;15;B;581;302;2;300;7;293;279;32;49;63;3;40;44;61;1
GIPUZKOA;69;DONOSTIA-SAN SEBASTI?N;7;16;U;792;385;3;382;9;373;407;45;32;99;1;51;46;99;0
GIPUZKOA;69;DONOSTIA-SAN SEBASTI?N;7;17;A;983;426;1;425;16;409;557;34;62;85;1;42;62;122;1
GIPUZKOA;69;DONOSTIA-SAN SEBASTI?N;7;17;B;965;408;0;408;6;402;557;56;59;72;0;39;54;122;0
GIPUZKOA;69;DONOSTIA-SAN SEBASTI?N;7;18;A;571;274;2;272;6;266;297;33;23;77;0;31;34;68;0
GIPUZKOA;69;DONOSTIA-SAN SEBASTI?N;7;18;B;594;284;9;275;9;266;310;32;26;69;2;34;29;74;0
GIPUZKOA;69;DONOSTIA-SAN SEBASTI?N;7;19;A;565;288;0;288;5;283;277;25;43;35;0;15;41;124;0
GIPUZKOA;69;DONOSTIA-SAN SEBASTI?N;7;19;B;675;351;0;351;10;341;324;29;43;29;1;11;47;181;0
GIPUZKOA;69;DONOSTIA-SAN SEBASTI?N;7;20;A;558;275;0;275;6;269;283;49;20;61;1;52;20;66;0
GIPUZKOA;69;DONOSTIA-SAN SEBASTI?N;7;20;B;506;244;8;236;1;235;262;42;24;64;0;24;26;55;0
GIPUZKOA;69;DONOSTIA-SAN SEBASTI?N;7;21;U;838;447;0;447;16;431;391;55;64;56;1;17;52;186;0
GIPUZKOA;69;DONOSTIA-SAN SEBASTI?N;7;22;A;576;308;1;307;6;301;268;37;36;56;0;32;27;113;0
GIPUZKOA;69;DONOSTIA-SAN SEBASTI?N;7;22;B;643;361;9;352;12;340;282;37;41;56;0;28;44;134;0
GIPUZKOA;69;DONOSTIA-SAN SEBASTI?N;7;23;A;651;331;3;328;5;323;320;58;28;124;1;50;14;47;1
GIPUZKOA;69;DONOSTIA-SAN SEBASTI?N;7;23;B;601;284;0;284;6;278;317;37;24;71;2;43;34;67;0
GIPUZKOA;69;DONOSTIA-SAN SEBASTI?N;7;24;A;974;438;0;438;10;428;536;33;44;102;0;49;66;131;3
GIPUZKOA;69;DONOSTIA-SAN SEBASTI?N;7;24;B;1001;415;0;415;9;406;586;57;53;71;2;41;61;120;1
GIPUZKOA;69;DONOSTIA-SAN SEBASTI?N;7;25;U;780;378;2;376;9;367;402;46;39;43;0;14;40;185;0
GIPUZKOA;69;DONOSTIA-SAN SEBASTI?N;7;26;U;541;238;0;238;7;231;303;33;30;53;0;39;28;48;0
GIPUZKOA;69;DONOSTIA-SAN SEBASTI?N;7;27;A;798;414;2;412;7;405;384;49;44;91;1;69;33;118;0
GIPUZKOA;69;DONOSTIA-SAN SEBASTI?N;7;27;B;786;392;0;392;8;384;394;44;57;109;0;43;28;103;0
GIPUZKOA;69;DONOSTIA-SAN SEBASTI?N;7;28;A;923;471;0;471;20;451;452;62;47;121;1;53;72;93;2
GIPUZKOA;69;DONOSTIA-SAN SEBASTI?N;7;28;B;869;414;1;413;25;388;455;64;35;101;2;54;58;74;0
GIPUZKOA;69;DONOSTIA-SAN SEBASTI?N;7;29;U;562;318;0;318;13;305;244;42;35;48;2;27;48;103;0
GIPUZKOA;69;DONOSTIA-SAN SEBASTI?N;7;30;A;666;310;0;310;11;299;356;32;26;91;2;31;39;77;1
GIPUZKOA;69;DONOSTIA-SAN SEBASTI?N;7;30;B;636;272;0;272;6;266;364;28;50;54;0;31;35;68;0
GIPUZKOA;70;SEGURA;1;1;A;608;461;0;461;9;452;147;109;9;142;0;187;2;3;0
GIPUZKOA;70;SEGURA;1;1;B;410;314;7;307;3;304;96;80;5;104;0;109;1;5;0
GIPUZKOA;71;TOLOSA;1;1;A;364;208;0;208;2;206;156;46;17;63;0;39;10;29;2
GIPUZKOA;71;TOLOSA;1;1;B;355;190;0;190;2;188;165;33;24;68;0;30;7;24;2
GIPUZKOA;71;TOLOSA;1;2;A;450;237;1;236;5;231;213;47;19;74;3;34;14;39;1
GIPUZKOA;71;TOLOSA;1;2;B;342;183;1;182;5;177;159;32;23;59;1;33;8;21;0
GIPUZKOA;71;TOLOSA;1;3;A;588;347;0;347;5;342;241;74;33;98;0;85;10;42;0
GIPUZKOA;71;TOLOSA;1;3;B;480;255;0;255;2;253;225;53;40;53;0;54;18;34;1
GIPUZKOA;71;TOLOSA;1;4;A;529;291;0;291;7;284;238;77;27;84;0;57;11;27;1
GIPUZKOA;71;TOLOSA;1;4;B;547;299;0;299;11;288;248;62;30;67;0;70;17;41;1
GIPUZKOA;71;TOLOSA;1;4;C;388;217;4;213;6;207;171;51;22;64;1;42;6;21;0
GIPUZKOA;71;TOLOSA;2;1;A;687;457;3;454;18;436;230;107;88;69;1;122;20;28;1
GIPUZKOA;71;TOLOSA;2;1;B;660;415;6;409;9;400;245;108;74;62;0;107;19;30;0
GIPUZKOA;71;TOLOSA;2;1;C;504;320;7;313;8;305;184;103;46;68;1;53;11;23;0
GIPUZKOA;71;TOLOSA;2;2;A;684;411;2;409;6;403;273;119;60;65;1;97;13;48;0
GIPUZKOA;71;TOLOSA;2;2;B;509;308;1;307;7;300;201;82;50;59;2;76;13;18;0
GIPUZKOA;71;TOLOSA;2;3;A;696;349;0;349;5;344;347;82;24;111;1;81;11;34;0
GIPUZKOA;71;TOLOSA;2;3;B;534;269;4;265;6;259;265;38;16;93;0;72;12;28;0
GIPUZKOA;71;TOLOSA;2;4;A;656;381;5;376;12;364;275;120;66;55;1;89;14;19;0
GIPUZKOA;71;TOLOSA;2;4;B;546;352;2;350;9;341;194;82;74;59;1;83;16;26;0
GIPUZKOA;71;TOLOSA;3;1;A;683;362;0;362;6;356;321;83;31;84;2;74;24;57;1
GIPUZKOA;71;TOLOSA;3;1;B;593;290;1;289;10;279;303;60;35;63;0;60;28;33;0
GIPUZKOA;71;TOLOSA;3;2;A;489;229;1;228;5;223;260;54;15;89;0;30;11;23;1
GIPUZKOA;71;TOLOSA;3;2;B;449;240;1;239;6;233;209;52;15;88;0;35;8;35;0
GIPUZKOA;71;TOLOSA;3;2;C;473;235;5;230;5;225;238;40;15;99;1;31;15;24;0
GIPUZKOA;71;TOLOSA;3;3;A;667;375;3;372;1;371;292;66;38;106;0;98;29;34;0
GIPUZKOA;71;TOLOSA;3;3;B;594;323;1;322;11;311;271;61;39;89;0;79;14;29;0
GIPUZKOA;71;TOLOSA;3;3;C;593;346;5;341;7;334;247;69;31;96;0;85;21;32;0
GIPUZKOA;71;TOLOSA;4;1;A;481;247;0;247;3;244;234;61;28;82;1;40;9;23;0
GIPUZKOA;71;TOLOSA;4;1;B;408;225;0;225;5;220;183;47;16;49;1;48;17;42;0
GIPUZKOA;72;URNIETA;1;1;A;597;350;4;346;15;331;247;127;11;87;0;28;13;65;0
GIPUZKOA;72;URNIETA;1;1;B;559;339;5;334;12;322;220;134;15;70;0;21;24;58;0
GIPUZKOA;72;URNIETA;1;2;U;869;488;2;486;19;467;381;152;28;124;1;41;27;93;1
GIPUZKOA;72;URNIETA;1;3;A;888;521;3;518;9;509;367;167;39;128;2;64;33;75;1
GIPUZKOA;72;URNIETA;1;3;B;786;459;1;458;5;453;327;159;33;83;1;44;38;95;0
GIPUZKOA;73;USURBIL;1;1;A;972;678;10;668;8;660;294;150;29;284;2;86;43;65;1
GIPUZKOA;73;USURBIL;1;1;B;819;545;4;541;15;526;274;105;24;214;3;82;27;70;1
GIPUZKOA;73;USURBIL;1;2;A;565;357;2;355;3;352;208;76;15;157;0;49;19;36;0
GIPUZKOA;73;USURBIL;1;2;B;605;366;1;365;3;362;239;62;18;165;1;49;21;46;0
GIPUZKOA;73;USURBIL;1;3;A;552;319;1;318;4;314;233;57;31;123;2;39;12;50;0
GIPUZKOA;73;USURBIL;1;3;B;557;346;0;346;3;343;211;59;23;126;2;61;21;48;3
GIPUZKOA;73;USURBIL;1;3;C;251;157;0;157;3;154;94;42;3;79;0;29;1;0;0
GIPUZKOA;74;BERGARA;1;1;A;717;435;0;435;6;429;282;103;25;155;0;73;35;38;0
GIPUZKOA;74;BERGARA;1;1;B;605;336;0;336;5;331;269;77;23;104;3;49;31;44;0
GIPUZKOA;74;BERGARA;1;2;A;988;632;0;632;8;624;356;213;41;191;0;141;12;25;1
GIPUZKOA;74;BERGARA;1;2;B;768;485;6;479;6;473;283;153;30;131;4;99;24;32;0
GIPUZKOA;74;BERGARA;1;3;U;672;485;1;484;15;469;187;141;12;149;2;105;22;38;0
GIPUZKOA;74;BERGARA;1;4;A;630;399;0;399;7;392;231;123;42;81;2;73;26;45;0
GIPUZKOA;74;BERGARA;1;4;B;553;364;5;359;4;355;189;118;34;73;2;61;19;48;0
GIPUZKOA;74;BERGARA;1;5;U;752;520;4;516;5;511;232;172;34;152;1;96;29;27;0
GIPUZKOA;74;BERGARA;2;1;U;1032;634;3;631;8;623;398;177;46;214;1;97;21;67;0
GIPUZKOA;74;BERGARA;2;2;U;1041;644;7;637;3;634;397;136;28;201;4;104;33;128;0
GIPUZKOA;74;BERGARA;2;3;A;801;455;2;453;4;449;346;134;17;173;1;64;23;36;1
GIPUZKOA;74;BERGARA;2;3;B;626;336;2;334;4;330;290;101;14;92;3;40;27;52;1
GIPUZKOA;74;BERGARA;2;4;U;562;356;0;356;4;352;206;124;12;143;0;49;11;13;0
GIPUZKOA;74;BERGARA;3;1;U;925;542;1;541;9;532;383;166;29;136;4;71;50;76;0
GIPUZKOA;74;BERGARA;3;2;A;568;315;0;315;5;310;253;75;10;107;0;34;29;55;0
GIPUZKOA;74;BERGARA;3;2;B;473;270;0;270;8;262;203;50;24;75;0;41;21;51;0
GIPUZKOA;74;BERGARA;3;3;U;1053;615;0;615;6;609;438;182;15;272;0;97;22;21;0
GIPUZKOA;75;VILLABONA;1;1;A;889;545;3;542;14;528;344;111;37;199;0;104;35;42;0
GIPUZKOA;75;VILLABONA;1;1;B;795;447;2;445;5;440;348;68;34;156;1;84;31;66;0
GIPUZKOA;75;VILLABONA;1;2;A;915;546;2;544;11;533;369;87;24;232;0;112;25;53;0
GIPUZKOA;75;VILLABONA;1;2;B;765;468;1;467;14;453;297;85;27;149;0;104;24;63;1
GIPUZKOA;75;VILLABONA;1;3;U;893;529;3;526;16;510;364;124;41;149;1;104;31;60;0
GIPUZKOA;76;ORDIZIA;1;1;U;724;491;0;491;13;478;233;132;65;114;0;96;22;49;0
GIPUZKOA;76;ORDIZIA;1;2;A;583;382;0;382;11;371;201;84;32;127;0;55;29;44;0
GIPUZKOA;76;ORDIZIA;1;2;B;447;284;3;281;8;273;163;58;26;84;1;48;21;35;0
GIPUZKOA;76;ORDIZIA;1;3;U;828;458;1;457;6;451;370;109;41;117;0;72;37;75;0
GIPUZKOA;76;ORDIZIA;1;4;A;963;634;8;626;17;609;329;178;69;154;1;112;37;58;0
GIPUZKOA;76;ORDIZIA;1;4;B;696;480;3;477;11;466;216;146;71;121;0;62;14;52;0
GIPUZKOA;76;ORDIZIA;1;5;A;510;336;3;333;15;318;174;71;29;115;0;46;19;38;0
GIPUZKOA;76;ORDIZIA;1;5;B;487;303;7;296;0;296;184;63;25;103;0;39;27;39;0
GIPUZKOA;76;ORDIZIA;1;6;A;694;421;1;420;12;408;273;77;45;88;0;49;66;82;1
GIPUZKOA;76;ORDIZIA;1;6;B;699;394;2;392;15;377;305;60;26;68;3;37;90;93;0
GIPUZKOA;76;ORDIZIA;1;7;A;502;327;3;324;12;312;175;60;19;93;0;55;31;51;3
GIPUZKOA;76;ORDIZIA;1;7;B;416;257;0;257;5;252;159;51;22;69;0;33;34;43;0
GIPUZKOA;77;URRETXU;1;1;U;718;443;4;439;14;425;275;96;20;87;6;74;46;94;2
GIPUZKOA;77;URRETXU;1;2;A;590;351;1;350;4;346;239;55;20;68;0;83;41;78;1
GIPUZKOA;77;URRETXU;1;2;B;478;314;0;314;7;307;164;45;11;62;1;68;44;75;1
GIPUZKOA;77;URRETXU;1;3;U;733;455;7;448;8;440;278;77;29;86;0;135;35;78;0
GIPUZKOA;77;URRETXU;1;4;A;845;577;6;571;9;562;268;119;45;86;0;173;34;104;1
GIPUZKOA;77;URRETXU;1;4;B;684;452;8;444;8;436;232;78;32;87;1;121;36;81;0
GIPUZKOA;77;URRETXU;1;5;U;1033;677;6;671;10;661;356;157;25;112;0;196;43;126;2
GIPUZKOA;78;ZALDIBIA;1;1;U;750;525;3;522;7;515;225;70;23;284;3;75;18;42;0
GIPUZKOA;78;ZALDIBIA;1;2;U;529;330;1;329;2;327;199;55;12;212;0;44;1;3;0
GIPUZKOA;79;ZARAUTZ;1;1;A;901;580;4;576;12;564;321;139;70;112;2;179;20;41;1
GIPUZKOA;79;ZARAUTZ;1;1;B;642;422;4;418;3;415;220;115;40;108;1;105;9;37;0
GIPUZKOA;79;ZARAUTZ;1;2;U;988;664;1;663;7;656;324;186;116;107;1;177;23;46;0
GIPUZKOA;79;ZARAUTZ;1;3;U;1068;682;7;675;11;664;386;152;82;119;2;254;18;36;1
GIPUZKOA;79;ZARAUTZ;2;1;U;578;381;3;378;12;366;197;118;59;31;2;124;5;27;0
GIPUZKOA;79;ZARAUTZ;2;2;A;806;526;5;521;6;515;280;141;77;82;0;177;15;22;1
GIPUZKOA;79;ZARAUTZ;2;2;B;587;388;2;386;10;376;199;112;61;56;0;117;14;16;0
GIPUZKOA;79;ZARAUTZ;2;3;A;868;502;2;500;14;486;366;85;48;137;0;120;21;74;1
GIPUZKOA;79;ZARAUTZ;2;3;B;740;436;2;434;15;419;304;85;33;116;4;103;22;56;0
GIPUZKOA;79;ZARAUTZ;2;4;A;696;387;3;384;11;373;309;50;28;99;1;95;32;67;1
GIPUZKOA;79;ZARAUTZ;2;4;B;700;373;0;373;15;358;327;47;33;75;1;83;39;80;0
GIPUZKOA;79;ZARAUTZ;2;5;A;831;535;1;534;15;519;296;108;32;132;2;125;20;100;0
GIPUZKOA;79;ZARAUTZ;2;5;B;729;405;9;396;6;390;324;98;23;64;1;95;26;83;0
GIPUZKOA;79;ZARAUTZ;2;6;A;828;540;1;539;15;524;288;97;34;132;3;168;26;64;0
GIPUZKOA;79;ZARAUTZ;2;6;B;638;399;6;393;6;387;239;74;36;68;1;109;26;73;0
GIPUZKOA;79;ZARAUTZ;2;7;A;913;528;3;525;11;514;385;123;49;113;3;131;28;66;1
GIPUZKOA;79;ZARAUTZ;2;7;B;405;245;0;245;8;237;160;62;5;64;0;94;8;4;0
GIPUZKOA;79;ZARAUTZ;2;8;A;903;541;9;532;25;507;362;140;86;78;2;135;24;42;0
GIPUZKOA;79;ZARAUTZ;2;8;B;646;381;3;378;12;366;265;89;55;60;2;104;13;43;0
GIPUZKOA;80;ZUMARRAGA;1;1;A;639;445;2;443;12;431;194;131;43;56;1;135;20;45;0
GIPUZKOA;80;ZUMARRAGA;1;1;B;498;332;1;331;10;321;166;96;28;30;1;106;23;37;0
GIPUZKOA;80;ZUMARRAGA;1;2;A;669;422;0;422;14;408;247;74;20;72;1;92;47;102;0
GIPUZKOA;80;ZUMARRAGA;1;2;B;570;361;8;353;11;342;209;78;21;50;0;48;45;100;0
GIPUZKOA;80;ZUMARRAGA;1;2;C;543;326;1;325;11;314;217;72;40;41;1;44;45;71;0
GIPUZKOA;80;ZUMARRAGA;1;3;U;694;412;2;410;11;399;282;93;30;69;1;87;27;92;0
GIPUZKOA;80;ZUMARRAGA;1;4;U;778;460;2;458;16;442;318;96;35;68;4;74;39;126;0
GIPUZKOA;80;ZUMARRAGA;1;5;A;678;419;7;412;11;401;259;42;35;27;4;31;99;163;0
GIPUZKOA;80;ZUMARRAGA;1;5;B;666;384;2;382;5;377;282;39;29;34;2;36;91;146;0
GIPUZKOA;80;ZUMARRAGA;1;6;A;917;568;0;568;16;552;349;81;25;84;1;87;91;183;0
GIPUZKOA;80;ZUMARRAGA;1;6;B;834;505;1;504;11;493;329;67;31;70;0;71;86;166;2
GIPUZKOA;80;ZUMARRAGA;1;7;U;560;318;0;318;8;310;242;73;13;57;2;94;21;50;0
GIPUZKOA;80;ZUMARRAGA;1;8;U;794;491;6;485;7;478;303;97;27;64;1;113;63;113;0
GIPUZKOA;81;ZUMAIA;1;1;A;907;596;3;593;12;581;311;226;40;150;1;111;13;40;0
GIPUZKOA;81;ZUMAIA;1;1;B;637;428;0;428;12;416;209;175;30;110;0;63;11;27;0
GIPUZKOA;81;ZUMAIA;1;2;A;667;403;0;403;6;397;264;114;24;98;0;41;22;98;0
GIPUZKOA;81;ZUMAIA;1;2;B;514;307;0;307;3;304;207;80;21;61;0;41;14;86;1
GIPUZKOA;81;ZUMAIA;1;3;A;944;565;6;559;15;544;379;180;23;138;2;86;25;90;0
GIPUZKOA;81;ZUMAIA;1;3;B;777;469;2;467;7;460;308;150;24;103;2;66;26;89;0
GIPUZKOA;81;ZUMAIA;1;4;A;798;483;1;482;5;477;315;195;23;110;1;77;14;57;0
GIPUZKOA;81;ZUMAIA;1;4;B;577;318;1;317;6;311;259;113;16;69;0;52;17;44;0
GIPUZKOA;81;ZUMAIA;1;5;U;597;353;3;350;12;338;244;117;22;63;0;46;20;70;0
GIPUZKOA;901;MENDARO;1;1;A;617;388;2;386;1;385;229;169;14;96;0;58;9;38;1
GIPUZKOA;901;MENDARO;1;1;B;549;353;3;350;6;344;196;163;13;79;0;45;12;32;0
GIPUZKOA;902;LASARTE-ORIA;1;1;U;502;322;0;322;4;318;180;50;11;162;0;64;10;21;0
GIPUZKOA;902;LASARTE-ORIA;1;2;A;677;369;1;368;13;355;308;43;51;48;1;27;62;122;1
GIPUZKOA;902;LASARTE-ORIA;1;2;B;768;418;2;416;17;399;350;59;51;31;2;33;63;160;0
GIPUZKOA;902;LASARTE-ORIA;1;3;A;965;548;6;542;6;536;417;49;72;80;2;53;58;222;0
GIPUZKOA;902;LASARTE-ORIA;1;3;B;925;520;6;514;9;505;405;50;57;95;1;38;72;191;1
GIPUZKOA;902;LASARTE-ORIA;1;4;U;959;555;3;552;7;545;404;83;39;128;4;67;36;187;1
GIPUZKOA;902;LASARTE-ORIA;1;5;U;861;496;1;495;8;487;365;83;79;97;8;67;47;106;0
GIPUZKOA;902;LASARTE-ORIA;1;6;A;624;352;0;352;7;345;272;76;15;80;0;71;18;85;0
GIPUZKOA;902;LASARTE-ORIA;1;6;B;628;367;1;366;4;362;261;67;19;109;0;62;17;88;0
GIPUZKOA;902;LASARTE-ORIA;1;7;A;847;498;3;495;13;482;349;72;66;47;1;34;56;206;0
GIPUZKOA;902;LASARTE-ORIA;1;7;B;1075;657;3;654;17;637;418;58;76;55;3;43;83;318;1
GIPUZKOA;902;LASARTE-ORIA;1;8;U;805;538;7;531;16;515;267;100;80;38;7;50;47;189;4
GIPUZKOA;902;LASARTE-ORIA;1;9;A;980;561;2;559;11;548;419;93;36;143;1;93;35;147;0
GIPUZKOA;902;LASARTE-ORIA;1;9;B;839;487;2;485;8;477;352;79;40;108;2;72;43;132;1
GIPUZKOA;902;LASARTE-ORIA;1;10;U;1018;574;2;572;9;563;444;68;61;98;1;61;70;203;1
GIPUZKOA;902;LASARTE-ORIA;1;11;U;976;556;3;553;9;544;420;74;40;141;0;50;49;189;1
GIPUZKOA;902;LASARTE-ORIA;1;12;A;514;294;3;291;5;286;220;25;33;71;1;25;34;96;1
GIPUZKOA;902;LASARTE-ORIA;1;12;B;636;365;2;363;6;357;271;46;41;59;2;38;50;120;1
GIPUZKOA;903;ASTIGARRAGA;1;1;A;937;563;7;556;5;551;374;122;37;194;1;142;22;33;0
GIPUZKOA;903;ASTIGARRAGA;1;1;B;891;507;4;503;10;493;384;62;48;222;1;100;24;36;0
GIPUZKOA;903;ASTIGARRAGA;1;2;U;694;450;1;449;2;447;244;108;5;180;0;134;8;12;0
GIPUZKOA;904;BALIARRAIN;1;1;U;85;58;0;58;0;58;27;13;0;37;0;8;0;0;0
GIPUZKOA;905;ORENDAIN;1;1;U;140;94;0;94;3;91;46;10;0;53;0;28;0;0;0
GIPUZKOA;906;ALTZAGA;1;1;U;79;48;0;48;0;48;31;15;1;20;0;12;0;0;0
GIPUZKOA;999;MUNICIPIO CERA GIPUZKOA;1;1;U;5661;1221;10;1211;3;1208;4440;285;175;149;3;161;88;334;13
BIZKAIA;1;ABADI?O;1;1;U;681;488;1;487;8;479;193;219;26;161;0;55;6;10;2
BIZKAIA;1;ABADI?O;1;2;U;814;504;1;503;6;497;310;210;61;84;3;24;32;81;2
BIZKAIA;1;ABADI?O;1;3;A;876;462;5;457;8;449;414;195;44;57;2;19;46;86;0
BIZKAIA;1;ABADI?O;1;3;B;705;417;2;415;8;407;288;124;63;47;1;17;53;100;2
BIZKAIA;1;ABADI?O;1;4;U;866;520;9;511;2;509;346;236;30;160;1;46;10;25;1
BIZKAIA;1;ABADI?O;1;5;A;799;485;6;479;5;474;314;154;56;97;1;41;41;83;1
BIZKAIA;1;ABADI?O;1;5;B;720;417;1;416;8;408;303;102;37;84;1;36;52;95;1
BIZKAIA;2;ABANTO Y CI?RVANA-ABANTO ZIERBENA;1;1;A;716;441;7;434;7;427;275;125;22;53;0;25;82;120;0
BIZKAIA;2;ABANTO Y CI?RVANA-ABANTO ZIERBENA;1;1;B;782;478;7;471;4;467;304;120;24;59;1;12;101;149;1
BIZKAIA;2;ABANTO Y CI?RVANA-ABANTO ZIERBENA;1;2;A;487;269;1;268;3;265;218;62;14;45;1;7;41;95;0
BIZKAIA;2;ABANTO Y CI?RVANA-ABANTO ZIERBENA;1;2;B;497;300;3;297;4;293;197;79;14;48;0;11;45;96;0
BIZKAIA;2;ABANTO Y CI?RVANA-ABANTO ZIERBENA;1;3;A;539;293;2;291;4;287;246;77;20;42;1;12;53;82;0
BIZKAIA;2;ABANTO Y CI?RVANA-ABANTO ZIERBENA;1;3;B;660;361;0;361;9;352;299;108;17;40;2;17;55;113;0
BIZKAIA;2;ABANTO Y CI?RVANA-ABANTO ZIERBENA;1;4;U;832;477;17;460;7;453;355;122;21;58;0;12;84;156;0
BIZKAIA;2;ABANTO Y CI?RVANA-ABANTO ZIERBENA;1;5;U;517;293;2;291;7;284;224;95;10;50;2;7;67;53;0
BIZKAIA;2;ABANTO Y CI?RVANA-ABANTO ZIERBENA;2;1;A;462;288;2;286;3;283;174;84;23;37;0;17;28;93;1
BIZKAIA;2;ABANTO Y CI?RVANA-ABANTO ZIERBENA;2;1;B;582;371;1;370;8;362;211;96;22;52;1;35;52;104;0
BIZKAIA;2;ABANTO Y CI?RVANA-ABANTO ZIERBENA;2;2;U;824;429;3;426;5;421;395;93;31;48;0;34;51;164;0
BIZKAIA;2;ABANTO Y CI?RVANA-ABANTO ZIERBENA;3;1;U;931;661;3;658;4;654;270;404;25;85;0;34;33;73;0
BIZKAIA;3;AMOREBIETA-ETXANO;1;1;U;1363;902;12;890;11;879;461;384;66;147;4;74;75;128;1
BIZKAIA;3;AMOREBIETA-ETXANO;1;2;U;946;631;1;630;9;621;315;244;31;101;2;51;84;108;0
BIZKAIA;3;AMOREBIETA-ETXANO;1;3;A;1073;753;1;752;4;748;320;356;31;189;2;74;42;54;0
BIZKAIA;3;AMOREBIETA-ETXANO;1;3;B;809;550;4;546;12;534;259;252;32;107;0;57;31;55;0
BIZKAIA;3;AMOREBIETA-ETXANO;1;4;U;1318;867;12;855;9;846;451;221;58;167;2;54;128;214;2
BIZKAIA;3;AMOREBIETA-ETXANO;1;5;U;925;622;7;615;9;606;303;217;51;109;1;75;69;83;1
BIZKAIA;3;AMOREBIETA-ETXANO;1;6;U;1157;711;6;705;10;695;446;164;62;110;3;51;110;193;2
BIZKAIA;3;AMOREBIETA-ETXANO;1;7;A;1027;739;8;731;14;717;288;343;45;158;2;95;22;51;1
BIZKAIA;3;AMOREBIETA-ETXANO;1;7;B;760;522;3;519;9;510;238;251;41;99;1;37;22;59;0
BIZKAIA;3;AMOREBIETA-ETXANO;1;8;U;1131;688;5;683;12;671;443;224;40;143;3;69;104;88;0
BIZKAIA;3;AMOREBIETA-ETXANO;1;9;U;957;622;9;613;11;602;335;211;34;122;1;67;78;88;1
BIZKAIA;3;AMOREBIETA-ETXANO;2;1;A;276;183;2;181;1;180;93;62;12;23;2;4;20;57;0
BIZKAIA;3;AMOREBIETA-ETXANO;2;1;B;242;171;0;171;2;169;71;96;2;49;0;19;2;1;0
BIZKAIA;3;AMOREBIETA-ETXANO;3;1;A;236;173;0;173;2;171;63;90;4;54;0;19;1;3;0
BIZKAIA;3;AMOREBIETA-ETXANO;3;1;B;776;579;3;576;8;568;197;361;6;127;0;44;14;16;0
BIZKAIA;4;AMOROTO;1;1;U;322;237;0;237;3;234;85;154;0;53;0;24;1;2;0
BIZKAIA;5;ARAKALDO;1;1;U;97;77;0;77;0;77;20;41;1;25;0;8;1;1;0
BIZKAIA;6;ARANTZAZU;1;1;U;240;196;4;192;4;188;44;91;10;67;0;18;2;0;0
BIZKAIA;7;MUNITIBAR-ARBATZEGI GERRIKAITZ-;1;1;U;373;273;3;270;4;266;100;172;2;74;0;18;0;0;0
BIZKAIA;8;ARTZENTALES;1;1;U;558;403;1;402;2;400;155;272;23;47;0;25;14;19;0
BIZKAIA;9;ARRANKUDIAGA;1;1;U;621;512;0;512;1;511;109;309;12;160;0;19;5;5;1
BIZKAIA;10;ARRIETA;1;1;U;378;268;7;261;1;260;110;175;16;36;0;28;4;1;0
BIZKAIA;11;ARRIGORRIAGA;1;1;A;560;331;1;330;3;327;229;116;12;88;2;12;35;61;1
BIZKAIA;11;ARRIGORRIAGA;1;1;B;583;343;2;341;6;335;240;135;31;69;2;10;38;50;0
BIZKAIA;11;ARRIGORRIAGA;1;2;A;994;516;1;515;15;500;478;130;43;92;3;20;82;127;3
BIZKAIA;11;ARRIGORRIAGA;1;2;B;955;514;4;510;8;502;441;130;46;60;0;14;79;173;0
BIZKAIA;11;ARRIGORRIAGA;1;3;U;677;384;5;379;7;372;293;70;25;53;0;6;84;133;1
BIZKAIA;11;ARRIGORRIAGA;1;4;U;1169;762;6;756;8;748;407;343;46;143;2;50;84;80;0
BIZKAIA;11;ARRIGORRIAGA;2;1;A;1049;727;3;724;10;714;322;381;53;110;2;47;53;68;0
BIZKAIA;11;ARRIGORRIAGA;2;1;B;920;563;13;550;6;544;357;270;51;86;1;38;42;56;0
BIZKAIA;11;ARRIGORRIAGA;2;2;A;641;407;7;400;7;393;234;173;26;95;2;25;23;49;0
BIZKAIA;11;ARRIGORRIAGA;2;2;B;629;389;3;386;5;381;240;156;27;81;0;17;28;71;1
BIZKAIA;12;BAKIO;1;1;U;1082;823;15;808;7;801;259;509;27;146;0;89;12;18;0
BIZKAIA;13;BARAKALDO;1;1;U;865;505;2;503;5;498;360;148;136;30;4;27;52;98;3
BIZKAIA;13;BARAKALDO;1;2;A;492;313;0;313;3;310;179;128;55;24;0;9;31;63;0
BIZKAIA;13;BARAKALDO;1;2;B;582;349;1;348;4;344;233;119;85;29;2;15;36;58;0
BIZKAIA;13;BARAKALDO;1;3;U;851;546;3;543;2;541;305;162;127;42;0;31;57;122;0
BIZKAIA;13;BARAKALDO;1;4;A;568;315;4;311;3;308;253;107;55;21;2;33;35;55;0
BIZKAIA;13;BARAKALDO;1;4;B;691;403;1;402;9;393;288;132;74;42;1;21;41;82;0
BIZKAIA;13;BARAKALDO;1;5;U;1027;600;4;596;14;582;427;150;110;69;2;31;60;159;1
BIZKAIA;13;BARAKALDO;1;6;U;938;457;0;457;4;453;481;108;74;36;3;17;51;164;0
BIZKAIA;13;BARAKALDO;1;7;U;721;388;1;387;6;381;333;65;74;25;0;12;60;143;2
BIZKAIA;13;BARAKALDO;1;8;U;679;363;2;361;8;353;316;69;68;47;0;22;46;101;0
BIZKAIA;13;BARAKALDO;1;9;U;697;418;4;414;7;407;279;123;96;29;1;18;40;99;1
BIZKAIA;13;BARAKALDO;2;1;U;969;522;3;519;6;513;447;158;108;35;1;23;64;124;0
BIZKAIA;13;BARAKALDO;2;2;A;514;294;1;293;3;290;220;91;59;19;0;18;26;77;0
BIZKAIA;13;BARAKALDO;2;2;B;601;341;5;336;4;332;260;101;57;23;0;15;42;93;1
BIZKAIA;13;BARAKALDO;2;3;U;924;509;1;508;4;504;415;184;86;54;2;22;65;91;0
BIZKAIA;13;BARAKALDO;2;4;A;455;221;1;220;4;216;234;42;35;22;1;9;34;72;1
BIZKAIA;13;BARAKALDO;2;4;B;586;279;0;279;1;278;307;68;50;23;1;11;34;91;0
BIZKAIA;13;BARAKALDO;2;5;U;824;394;1;393;2;391;430;88;46;60;1;12;70;112;2
BIZKAIA;13;BARAKALDO;2;6;A;671;343;0;343;9;334;328;97;37;40;0;15;46;99;0
BIZKAIA;13;BARAKALDO;2;6;B;753;410;0;410;8;402;343;125;82;49;0;10;41;95;0
BIZKAIA;13;BARAKALDO;2;7;U;681;414;1;413;6;407;267;94;71;38;4;10;63;127;0
BIZKAIA;13;BARAKALDO;2;8;U;850;460;1;459;6;453;390;108;73;41;2;27;57;144;1
BIZKAIA;13;BARAKALDO;2;9;U;630;344;2;342;9;333;286;78;47;32;0;13;58;104;1
BIZKAIA;13;BARAKALDO;2;10;A;691;353;3;350;5;345;338;77;46;37;5;10;45;125;0
BIZKAIA;13;BARAKALDO;2;10;B;743;398;1;397;3;394;345;80;62;41;1;14;65;130;1
BIZKAIA;13;BARAKALDO;3;1;U;1080;575;5;570;10;560;505;137;90;41;1;21;84;186;0
BIZKAIA;13;BARAKALDO;3;2;A;603;325;13;312;0;312;278;65;48;30;2;12;62;92;1
BIZKAIA;13;BARAKALDO;3;2;B;699;368;2;366;5;361;331;73;46;32;0;17;56;136;1
BIZKAIA;13;BARAKALDO;3;3;U;872;532;1;531;8;523;340;171;84;37;2;21;68;140;0
BIZKAIA;13;BARAKALDO;3;4;A;620;363;4;359;8;351;257;76;75;24;0;7;54;115;0
BIZKAIA;13;BARAKALDO;3;4;B;589;338;0;338;7;331;251;84;69;16;0;1;54;107;0
BIZKAIA;13;BARAKALDO;3;5;U;920;565;5;560;9;551;355;183;146;29;1;30;60;101;1
BIZKAIA;13;BARAKALDO;3;6;A;423;229;0;229;3;226;194;43;34;20;0;4;50;72;3
BIZKAIA;13;BARAKALDO;3;6;B;484;255;1;254;1;253;229;58;27;16;0;7;44;100;1
BIZKAIA;13;BARAKALDO;3;7;U;877;474;4;470;6;464;403;76;64;42;1;19;66;196;0
BIZKAIA;13;BARAKALDO;3;8;U;607;346;0;346;10;336;261;92;49;23;0;14;54;104;0
BIZKAIA;13;BARAKALDO;4;1;A;517;271;0;271;2;269;246;46;46;22;0;22;37;96;0
BIZKAIA;13;BARAKALDO;4;1;B;503;287;0;287;2;285;216;46;61;17;3;11;38;109;0
BIZKAIA;13;BARAKALDO;4;2;U;728;453;0;453;8;445;275;126;95;52;0;27;43;102;0
BIZKAIA;13;BARAKALDO;4;3;U;921;508;2;506;6;500;413;106;75;55;2;23;79;159;1
BIZKAIA;13;BARAKALDO;4;4;A;534;288;2;286;3;283;246;65;42;53;1;16;31;75;0
BIZKAIA;13;BARAKALDO;4;4;B;655;356;2;354;8;346;299;102;48;49;1;23;33;89;1
BIZKAIA;13;BARAKALDO;4;5;U;736;437;2;435;4;431;299;116;80;55;3;13;46;118;0
BIZKAIA;13;BARAKALDO;4;6;U;766;444;2;442;4;438;322;147;79;51;2;17;46;94;2
BIZKAIA;13;BARAKALDO;4;7;A;667;402;0;402;5;397;265;92;65;33;2;17;77;111;0
BIZKAIA;13;BARAKALDO;4;7;B;688;412;1;411;9;402;276;77;61;52;1;17;75;117;2
BIZKAIA;13;BARAKALDO;4;8;U;675;430;6;424;8;416;245;101;49;65;0;30;72;99;0
BIZKAIA;13;BARAKALDO;4;9;U;933;566;1;565;11;554;367;108;74;94;3;31;86;157;1
BIZKAIA;13;BARAKALDO;4;10;U;1079;648;1;647;13;634;431;133;94;68;1;18;117;202;1
BIZKAIA;13;BARAKALDO;4;11;U;626;376;3;373;1;372;250;97;31;71;0;16;59;98;0
BIZKAIA;13;BARAKALDO;5;1;A;689;398;1;397;7;390;291;96;77;45;2;20;56;93;1
BIZKAIA;13;BARAKALDO;5;1;B;790;452;4;448;10;438;338;112;82;43;1;16;74;110;0
BIZKAIA;13;BARAKALDO;5;2;A;685;424;0;424;5;419;261;102;56;60;0;19;73;108;1
BIZKAIA;13;BARAKALDO;5;2;B;673;370;5;365;6;359;303;72;55;29;0;22;57;123;1
BIZKAIA;13;BARAKALDO;5;3;A;438;249;5;244;2;242;189;65;51;24;0;12;33;56;1
BIZKAIA;13;BARAKALDO;5;3;B;526;296;2;294;5;289;230;72;52;32;0;14;44;75;0
BIZKAIA;13;BARAKALDO;5;4;U;741;401;1;400;9;391;340;79;72;45;1;22;60;108;4
BIZKAIA;13;BARAKALDO;5;5;A;763;483;1;482;15;467;280;144;98;43;1;33;52;93;3
BIZKAIA;13;BARAKALDO;5;5;B;820;529;0;529;13;516;291;144;107;39;2;40;67;115;2
BIZKAIA;13;BARAKALDO;5;6;A;774;435;0;435;8;427;339;117;64;76;1;26;43;99;1
BIZKAIA;13;BARAKALDO;5;6;B;734;422;2;420;8;412;312;95;83;52;2;15;55;109;1
BIZKAIA;13;BARAKALDO;5;7;A;689;416;0;416;5;411;273;110;62;40;2;20;73;103;1
BIZKAIA;13;BARAKALDO;5;7;B;712;441;0;441;3;438;271;109;94;33;3;17;67;112;3
BIZKAIA;13;BARAKALDO;5;8;A;458;244;1;243;5;238;214;49;32;27;0;18;41;71;0
BIZKAIA;13;BARAKALDO;5;8;B;541;301;0;301;5;296;240;73;51;31;0;20;52;67;2
BIZKAIA;13;BARAKALDO;5;9;U;798;497;4;493;3;490;301;94;75;54;0;34;86;145;2
BIZKAIA;13;BARAKALDO;5;10;A;534;293;2;291;7;284;241;69;43;20;0;12;51;85;4
BIZKAIA;13;BARAKALDO;5;10;B;502;266;0;266;3;263;236;60;38;28;1;12;50;74;0
BIZKAIA;13;BARAKALDO;6;1;U;1212;689;4;685;7;678;523;175;104;40;2;31;82;239;5
BIZKAIA;13;BARAKALDO;6;2;U;1007;553;2;551;16;535;454;146;87;37;0;31;74;160;0
BIZKAIA;13;BARAKALDO;6;3;U;950;517;5;512;16;496;433;117;94;32;1;6;109;137;0
BIZKAIA;13;BARAKALDO;6;4;A;537;294;7;287;3;284;243;66;46;23;0;8;60;81;0
BIZKAIA;13;BARAKALDO;6;4;B;606;314;1;313;5;308;292;74;52;24;0;15;66;77;0
BIZKAIA;13;BARAKALDO;6;5;A;518;298;4;294;1;293;220;71;35;38;1;13;39;96;0
BIZKAIA;13;BARAKALDO;6;5;B;634;363;2;361;9;352;271;77;52;35;0;24;47;117;0
BIZKAIA;13;BARAKALDO;6;6;U;1024;553;4;549;10;539;471;129;75;65;0;19;82;169;0
BIZKAIA;13;BARAKALDO;6;7;A;651;342;3;339;3;336;309;68;21;48;1;12;81;104;1
BIZKAIA;13;BARAKALDO;6;7;B;685;369;1;368;6;362;316;57;29;56;3;15;90;111;1
BIZKAIA;13;BARAKALDO;6;8;U;968;586;3;583;17;566;382;146;96;41;2;24;115;142;0
BIZKAIA;13;BARAKALDO;6;9;U;856;497;3;494;7;487;359;97;60;52;1;18;129;130;0
BIZKAIA;13;BARAKALDO;6;10;U;828;475;2;473;6;467;353;103;67;59;0;20;92;126;0
BIZKAIA;13;BARAKALDO;6;11;U;995;546;0;546;15;531;449;110;73;69;4;32;92;151;0
BIZKAIA;13;BARAKALDO;6;12;U;605;322;3;319;7;312;283;65;36;48;0;10;48;105;0
BIZKAIA;13;BARAKALDO;7;1;A;788;431;0;431;6;425;357;147;53;41;0;22;61;100;1
BIZKAIA;13;BARAKALDO;7;1;B;871;491;2;489;6;483;380;141;74;55;1;26;90;96;0
BIZKAIA;13;BARAKALDO;7;2;A;608;348;8;340;6;334;260;75;35;46;0;20;55;102;1
BIZKAIA;13;BARAKALDO;7;2;B;656;355;4;351;9;342;301;75;33;51;0;27;51;105;0
BIZKAIA;13;BARAKALDO;7;3;U;1137;623;2;621;13;608;514;138;80;49;2;29;120;188;2
BIZKAIA;13;BARAKALDO;7;4;A;623;328;4;324;1;323;295;109;34;55;0;13;30;77;5
BIZKAIA;13;BARAKALDO;7;4;B;394;241;1;240;5;235;153;98;6;47;0;28;23;33;0
BIZKAIA;13;BARAKALDO;8;1;U;726;426;2;424;3;421;300;130;34;93;0;23;51;88;2
BIZKAIA;13;BARAKALDO;8;2;U;1099;579;8;571;5;566;520;160;52;89;2;27;81;153;2
BIZKAIA;13;BARAKALDO;8;3;A;490;283;1;282;0;282;207;85;18;47;0;16;29;87;0
BIZKAIA;13;BARAKALDO;8;3;B;476;267;1;266;3;263;209;81;21;48;0;14;29;69;1
BIZKAIA;13;BARAKALDO;8;4;A;620;353;5;348;5;343;267;75;41;29;0;14;43;137;4
BIZKAIA;13;BARAKALDO;8;4;B;625;347;0;347;16;331;278;87;41;20;0;15;41;127;0
BIZKAIA;13;BARAKALDO;8;5;U;1026;562;0;562;12;550;464;101;88;47;3;13;101;195;2
BIZKAIA;13;BARAKALDO;8;6;U;885;516;1;515;0;515;369;106;49;60;2;15;110;171;2
BIZKAIA;13;BARAKALDO;8;7;U;1023;616;2;614;12;602;407;259;93;71;3;23;68;85;0
BIZKAIA;13;BARAKALDO;8;8;A;806;379;1;378;8;370;427;89;49;62;3;14;51;102;0
BIZKAIA;13;BARAKALDO;8;8;B;369;264;0;264;2;262;105;96;4;39;0;91;8;24;0
BIZKAIA;13;BARAKALDO;9;1;U;581;313;0;313;5;308;268;108;67;18;0;7;40;68;0
BIZKAIA;13;BARAKALDO;9;2;U;990;503;4;499;8;491;487;146;77;44;0;15;68;141;0
BIZKAIA;13;BARAKALDO;9;3;A;542;277;2;275;2;273;265;79;28;33;0;5;34;94;0
BIZKAIA;13;BARAKALDO;9;3;B;590;306;2;304;2;302;284;83;35;32;1;10;31;110;0
BIZKAIA;13;BARAKALDO;9;4;A;589;304;2;302;6;296;285;64;58;37;0;5;39;93;0
BIZKAIA;13;BARAKALDO;9;4;B;581;338;4;334;2;332;243;80;63;32;2;13;45;95;2
BIZKAIA;13;BARAKALDO;9;5;A;567;340;4;336;2;334;227;79;43;61;3;13;43;91;1
BIZKAIA;13;BARAKALDO;9;5;B;560;313;0;313;3;310;247;87;25;50;1;16;34;97;0
BIZKAIA;13;BARAKALDO;9;6;U;854;470;2;468;7;461;384;89;57;42;2;13;79;178;1
BIZKAIA;13;BARAKALDO;9;7;A;801;440;8;432;2;430;361;104;62;49;4;11;97;103;0
BIZKAIA;13;BARAKALDO;9;7;B;808;444;9;435;12;423;364;105;49;58;0;15;81;115;0
BIZKAIA;13;BARAKALDO;9;8;U;652;342;4;338;3;335;310;130;28;53;1;7;37;78;1
BIZKAIA;13;BARAKALDO;9;9;A;707;400;4;396;10;386;307;81;62;39;4;15;63;119;3
BIZKAIA;13;BARAKALDO;9;9;B;718;422;6;416;5;411;296;103;56;34;0;16;75;127;0
BIZKAIA;13;BARAKALDO;9;10;A;596;358;2;356;2;354;238;89;52;35;5;5;72;95;1
BIZKAIA;13;BARAKALDO;9;10;B;594;341;6;335;4;331;253;52;59;25;1;6;64;124;0
BIZKAIA;13;BARAKALDO;9;11;U;630;352;0;352;9;343;278;109;31;42;0;25;61;74;1
BIZKAIA;13;BARAKALDO;9;12;U;1043;550;0;550;11;539;493;141;69;57;3;27;99;143;0
BIZKAIA;14;BARRIKA;1;1;U;735;492;3;489;11;478;243;268;33;91;1;41;18;25;1
BIZKAIA;15;BASAURI;1;1;U;612;349;2;347;2;345;263;143;36;44;1;24;33;64;0
BIZKAIA;15;BASAURI;1;2;U;1110;550;2;548;9;539;560;144;82;28;2;14;114;153;2
BIZKAIA;15;BASAURI;1;3;U;872;548;2;546;4;542;324;224;74;68;1;17;52;106;0
BIZKAIA;15;BASAURI;1;4;U;1002;504;1;503;11;492;498;192;83;59;2;16;47;91;2
BIZKAIA;15;BASAURI;1;5;U;1091;622;3;619;16;603;469;212;85;54;4;26;61;161;0
BIZKAIA;15;BASAURI;1;6;A;667;333;2;331;7;324;334;91;41;38;2;8;61;83;0
BIZKAIA;15;BASAURI;1;6;B;641;362;0;362;6;356;279;91;49;48;1;5;65;97;0
BIZKAIA;15;BASAURI;1;7;U;999;505;4;501;6;495;494;140;71;61;0;8;80;135;0
BIZKAIA;15;BASAURI;1;8;A;1044;566;2;564;5;559;478;158;89;60;2;11;76;162;1
BIZKAIA;15;BASAURI;1;8;B;970;506;1;505;6;499;464;120;80;43;1;17;77;161;0
BIZKAIA;15;BASAURI;1;9;A;734;349;2;347;6;341;385;91;58;34;2;11;52;93;0
BIZKAIA;15;BASAURI;1;9;B;786;399;2;397;5;392;387;94;84;33;1;7;65;105;3
BIZKAIA;15;BASAURI;1;10;A;735;338;0;338;5;333;397;82;45;27;0;7;41;131;0
BIZKAIA;15;BASAURI;1;10;B;792;423;0;423;2;421;369;134;48;40;5;8;61;125;0
BIZKAIA;15;BASAURI;1;11;A;699;340;1;339;4;335;359;76;38;37;1;11;54;118;0
BIZKAIA;15;BASAURI;1;11;B;716;372;6;366;5;361;344;95;28;31;1;9;66;131;0
BIZKAIA;15;BASAURI;1;12;U;708;411;0;411;5;406;297;126;32;67;2;18;62;99;0
BIZKAIA;15;BASAURI;2;1;U;690;447;0;447;7;440;243;196;48;60;0;47;25;64;0
BIZKAIA;15;BASAURI;2;2;U;935;596;1;595;10;585;339;248;85;63;0;21;60;108;0
BIZKAIA;15;BASAURI;2;3;U;1091;699;1;698;13;685;392;338;80;77;2;29;54;104;1
BIZKAIA;15;BASAURI;2;4;A;647;353;1;352;8;344;294;146;38;48;1;10;32;68;1
BIZKAIA;15;BASAURI;2;4;B;578;315;0;315;6;309;263;97;38;33;1;15;38;86;1
BIZKAIA;15;BASAURI;2;5;U;1101;645;0;645;16;629;456;261;55;86;3;22;61;141;0
BIZKAIA;15;BASAURI;2;6;U;1071;574;7;567;10;557;497;181;81;57;8;20;48;162;0
BIZKAIA;15;BASAURI;2;7;U;983;571;7;564;7;557;412;214;74;81;1;36;54;97;0
BIZKAIA;15;BASAURI;2;8;U;937;526;2;524;8;516;411;190;65;63;1;24;65;108;0
BIZKAIA;15;BASAURI;2;9;U;745;436;1;435;4;431;309;147;51;70;2;14;39;108;0
BIZKAIA;15;BASAURI;2;10;U;924;501;1;500;7;493;423;159;41;66;0;25;61;138;3
BIZKAIA;15;BASAURI;2;11;U;576;357;3;354;5;349;219;150;31;68;0;18;27;55;0
BIZKAIA;15;BASAURI;2;12;U;1098;624;0;624;7;617;474;244;69;63;1;35;60;145;0
BIZKAIA;15;BASAURI;2;13;A;730;441;0;441;9;432;289;142;48;73;0;15;50;104;0
BIZKAIA;15;BASAURI;2;13;B;760;440;4;436;7;429;320;123;52;62;1;22;50;118;1
BIZKAIA;15;BASAURI;2;14;U;952;521;6;515;4;511;431;173;46;89;0;29;30;141;3
BIZKAIA;15;BASAURI;2;15;A;898;513;0;513;9;504;385;192;75;58;0;20;50;109;0
BIZKAIA;15;BASAURI;2;15;B;846;478;3;475;6;469;368;166;65;49;0;21;59;109;0
BIZKAIA;15;BASAURI;2;17;U;666;464;3;461;9;452;202;239;47;47;0;33;22;64;0
BIZKAIA;15;BASAURI;2;18;U;1056;614;6;608;15;593;442;162;88;65;0;22;61;192;3
BIZKAIA;15;BASAURI;3;1;A;829;438;2;436;2;434;391;120;38;66;3;11;62;132;2
BIZKAIA;15;BASAURI;3;1;B;761;407;0;407;7;400;354;105;47;35;4;12;64;132;1
BIZKAIA;15;BASAURI;3;2;U;943;522;3;519;12;507;421;139;64;44;0;26;57;177;0
BIZKAIA;15;BASAURI;3;3;U;613;359;4;355;8;347;254;126;49;38;1;26;38;69;0
BIZKAIA;15;BASAURI;3;4;U;618;299;4;295;5;290;319;100;35;26;1;7;30;91;0
BIZKAIA;15;BASAURI;4;1;A;987;511;2;509;5;504;476;172;60;86;2;27;53;102;2
BIZKAIA;15;BASAURI;4;1;B;1021;559;8;551;5;546;462;173;61;80;2;20;69;141;0
BIZKAIA;15;BASAURI;5;1;A;781;485;0;485;4;481;296;195;25;93;1;27;52;88;0
BIZKAIA;15;BASAURI;5;1;B;779;464;3;461;5;456;315;189;20;77;0;35;60;73;2
BIZKAIA;15;BASAURI;5;2;U;765;439;1;438;2;436;326;125;29;54;2;22;73;131;0
BIZKAIA;15;BASAURI;5;3;U;815;459;0;459;7;452;356;111;35;78;2;8;100;118;0
BIZKAIA;16;BERANGO;1;1;U;878;550;7;543;5;538;328;217;38;99;0;65;43;76;0
BIZKAIA;16;BERANGO;1;2;A;703;472;1;471;4;467;231;200;56;89;2;45;35;40;0
BIZKAIA;16;BERANGO;1;2;B;703;438;0;438;15;423;265;180;48;59;1;43;41;48;3
BIZKAIA;16;BERANGO;1;3;A;591;404;2;402;0;402;187;152;24;114;0;62;24;26;0
BIZKAIA;16;BERANGO;1;3;B;580;414;3;411;3;408;166;164;27;106;1;46;29;35;0
BIZKAIA;17;BERMEO;1;1;U;554;341;0;341;1;340;213;84;13;77;0;122;12;32;0
BIZKAIA;17;BERMEO;1;2;U;835;469;1;468;1;467;366;164;18;116;0;115;11;43;0
BIZKAIA;17;BERMEO;1;3;U;627;405;6;399;2;397;222;136;8;89;0;130;15;19;0
BIZKAIA;17;BERMEO;1;4;U;621;436;5;431;5;426;185;183;16;89;0;117;10;11;0
BIZKAIA;17;BERMEO;1;5;U;778;471;7;464;1;463;307;125;12;107;3;166;7;42;1
BIZKAIA;17;BERMEO;2;1;U;821;562;3;559;7;552;259;186;38;108;3;169;16;32;0
BIZKAIA;17;BERMEO;2;2;A;711;474;2;472;6;466;237;182;15;104;0;118;9;38;0
BIZKAIA;17;BERMEO;2;2;B;633;387;4;383;7;376;246;133;9;83;0;101;10;40;0
BIZKAIA;17;BERMEO;2;3;A;817;538;6;532;0;532;279;193;14;122;3;152;8;40;0
BIZKAIA;17;BERMEO;2;3;B;702;406;1;405;2;403;296;152;14;72;1;122;6;36;0
BIZKAIA;17;BERMEO;2;4;U;1176;770;0;770;10;760;406;342;11;131;0;204;16;56;0
BIZKAIA;17;BERMEO;2;5;U;943;531;1;530;5;525;412;161;18;126;2;112;17;88;1
BIZKAIA;17;BERMEO;2;6;U;673;437;8;429;1;428;236;246;14;43;0;122;2;1;0
BIZKAIA;17;BERMEO;3;1;U;1083;581;4;577;11;566;502;174;21;136;5;144;30;55;1
BIZKAIA;17;BERMEO;3;2;A;964;645;10;635;2;633;319;281;18;128;0;149;15;42;0
BIZKAIA;17;BERMEO;3;2;B;751;495;5;490;3;487;256;202;9;106;1;119;12;38;0
BIZKAIA;17;BERMEO;3;3;A;995;696;4;692;3;689;299;348;20;123;0;169;11;18;0
BIZKAIA;17;BERMEO;3;3;B;759;507;4;503;3;500;252;247;16;74;0;132;14;17;0
BIZKAIA;18;BERRIATUA;1;1;U;829;487;0;487;3;484;342;281;8;123;0;51;8;13;0
BIZKAIA;19;BERRIZ;1;1;A;586;387;1;386;5;381;199;166;18;72;4;30;34;57;0
BIZKAIA;19;BERRIZ;1;1;B;447;293;2;291;4;287;154;132;20;30;3;24;32;44;2
BIZKAIA;19;BERRIZ;1;2;A;433;300;5;295;3;292;133;167;3;91;0;28;2;1;0
BIZKAIA;19;BERRIZ;1;2;B;365;261;3;258;5;253;104;129;21;74;0;24;2;3;0
BIZKAIA;19;BERRIZ;1;3;A;801;491;1;490;4;486;310;215;38;66;3;28;50;86;0
BIZKAIA;19;BERRIZ;1;3;B;751;426;3;423;4;419;325;163;42;67;2;15;27;101;2
BIZKAIA;20;BILBAO;1;1;U;525;303;2;301;3;298;222;103;40;52;3;14;39;46;1
BIZKAIA;20;BILBAO;1;2;U;812;447;5;442;7;435;365;134;96;43;1;19;60;81;1
BIZKAIA;20;BILBAO;1;3;U;810;515;2;513;6;507;295;153;98;53;4;23;79;95;2
BIZKAIA;20;BILBAO;1;4;U;528;324;2;322;5;317;204;104;57;38;1;12;38;65;2
BIZKAIA;20;BILBAO;1;5;U;770;469;5;464;8;456;301;110;117;43;1;18;74;91;2
BIZKAIA;20;BILBAO;1;6;A;785;449;3;446;9;437;336;119;93;50;1;12;64;96;2
BIZKAIA;20;BILBAO;1;6;B;786;453;1;452;10;442;333;121;101;33;2;22;69;93;1
BIZKAIA;20;BILBAO;1;7;U;822;498;0;498;4;494;324;178;80;37;2;36;70;90;1
BIZKAIA;20;BILBAO;1;8;U;697;420;4;416;8;408;277;118;73;53;2;26;60;75;1
BIZKAIA;20;BILBAO;1;9;A;600;380;2;378;13;365;220;105;72;34;0;16;44;93;1
BIZKAIA;20;BILBAO;1;9;B;627;385;2;383;14;369;242;112;81;35;0;20;43;78;0
BIZKAIA;20;BILBAO;1;10;U;767;398;3;395;16;379;369;136;72;40;3;22;52;53;1
BIZKAIA;20;BILBAO;1;11;U;1120;683;6;677;13;664;437;219;138;82;2;23;86;114;0
BIZKAIA;20;BILBAO;1;12;U;671;396;0;396;9;387;275;138;114;25;2;12;36;60;0
BIZKAIA;20;BILBAO;1;13;U;613;381;8;373;1;372;232;128;78;30;0;15;42;78;1
BIZKAIA;20;BILBAO;1;14;U;507;314;0;314;2;312;193;79;71;49;2;28;27;56;0
BIZKAIA;20;BILBAO;1;15;U;722;384;7;377;8;369;338;109;63;28;1;12;60;93;3
BIZKAIA;20;BILBAO;1;16;A;760;442;11;431;0;431;318;167;92;38;0;17;49;68;0
BIZKAIA;20;BILBAO;1;16;B;846;480;4;476;6;470;366;170;108;37;0;29;54;71;1
BIZKAIA;20;BILBAO;1;17;A;580;357;1;356;5;351;223;134;84;24;1;17;36;55;0
BIZKAIA;20;BILBAO;1;17;B;610;380;0;380;4;376;230;118;104;32;0;18;41;63;0
BIZKAIA;20;BILBAO;1;18;A;632;401;1;400;10;390;231;136;81;39;0;20;40;73;1
BIZKAIA;20;BILBAO;1;18;B;620;379;2;377;3;374;241;122;70;32;0;12;61;77;0
BIZKAIA;20;BILBAO;1;19;U;1013;536;5;531;14;517;477;187;83;46;4;33;55;107;2
BIZKAIA;20;BILBAO;1;20;U;934;590;3;587;11;576;344;207;124;48;2;23;90;80;2
BIZKAIA;20;BILBAO;1;21;A;556;303;4;299;3;296;253;103;36;35;0;19;41;62;0
BIZKAIA;20;BILBAO;1;21;B;617;357;0;357;8;349;260;113;36;52;0;27;42;78;1
BIZKAIA;20;BILBAO;1;22;A;747;485;3;482;10;472;262;133;113;67;3;30;53;73;0
BIZKAIA;20;BILBAO;1;22;B;752;460;0;460;12;448;292;126;121;44;2;22;67;66;0
BIZKAIA;20;BILBAO;1;23;U;1180;720;6;714;9;705;460;224;152;61;1;35;80;151;1
BIZKAIA;20;BILBAO;1;25;A;660;437;5;432;15;417;223;156;103;39;0;26;38;54;1
BIZKAIA;20;BILBAO;1;25;B;736;470;2;468;11;457;266;177;102;32;1;31;57;57;0
BIZKAIA;20;BILBAO;1;26;U;1112;677;0;677;21;656;435;279;119;75;3;42;51;87;0
BIZKAIA;20;BILBAO;1;27;U;1055;568;3;565;8;557;487;143;76;41;1;27;111;158;0
BIZKAIA;20;BILBAO;1;28;A;694;410;1;409;5;404;284;68;60;33;0;7;82;154;0
BIZKAIA;20;BILBAO;1;28;B;691;400;3;397;13;384;291;76;52;20;0;8;84;143;1
BIZKAIA;20;BILBAO;1;29;A;800;437;4;433;5;428;363;74;40;47;1;18;75;173;0
BIZKAIA;20;BILBAO;1;29;B;846;459;3;456;14;442;387;76;57;45;2;14;77;171;0
BIZKAIA;20;BILBAO;1;30;A;672;454;1;453;15;438;218;168;72;38;1;44;62;53;0
BIZKAIA;20;BILBAO;1;30;B;686;445;10;435;11;424;241;163;76;36;2;31;53;63;0
BIZKAIA;20;BILBAO;1;31;A;646;392;5;387;9;378;254;150;79;44;0;23;38;44;0
BIZKAIA;20;BILBAO;1;31;B;660;411;2;409;15;394;249;164;65;37;2;26;43;57;0
BIZKAIA;20;BILBAO;1;32;A;917;577;0;577;8;569;340;235;116;60;0;42;54;62;0
BIZKAIA;20;BILBAO;1;32;B;785;521;1;520;7;513;264;162;140;53;1;29;53;74;1
BIZKAIA;20;BILBAO;1;33;U;918;651;0;651;7;644;267;223;151;61;0;66;74;69;0
BIZKAIA;20;BILBAO;1;34;U;735;496;1;495;16;479;239;225;118;35;4;36;28;33;0
BIZKAIA;20;BILBAO;1;35;U;858;489;6;483;3;480;369;169;96;71;2;38;30;74;0
BIZKAIA;20;BILBAO;1;36;U;742;450;1;449;6;443;292;179;92;42;3;42;26;59;0
BIZKAIA;20;BILBAO;1;37;U;822;503;3;500;9;491;319;236;111;40;1;35;29;38;1
BIZKAIA;20;BILBAO;1;38;A;437;243;1;242;6;236;194;115;17;37;0;12;21;34;0
BIZKAIA;20;BILBAO;1;38;B;885;584;4;580;5;575;301;265;91;43;0;61;49;66;0
BIZKAIA;20;BILBAO;1;39;U;697;465;1;464;12;452;232;150;153;38;2;28;36;45;0
BIZKAIA;20;BILBAO;1;40;U;808;513;0;513;14;499;295;209;110;54;4;30;35;56;1
BIZKAIA;20;BILBAO;1;41;U;1090;687;3;684;16;668;403;267;159;78;1;44;43;74;2
BIZKAIA;20;BILBAO;1;42;A;826;546;20;526;0;526;280;224;111;43;1;38;41;67;1
BIZKAIA;20;BILBAO;1;42;B;787;505;1;504;9;495;282;174;124;48;4;32;40;73;0
BIZKAIA;20;BILBAO;1;43;U;937;664;4;660;12;648;273;291;162;39;0;42;52;62;0
BIZKAIA;20;BILBAO;1;44;U;1172;797;3;794;18;776;375;314;190;56;3;64;63;85;1
BIZKAIA;20;BILBAO;1;45;A;801;496;4;492;10;482;305;177;88;67;1;31;38;78;2
BIZKAIA;20;BILBAO;1;45;B;728;419;2;417;9;408;309;162;96;28;2;39;26;55;0
BIZKAIA;20;BILBAO;2;1;A;720;391;2;389;12;377;329;124;89;36;2;4;51;71;0
BIZKAIA;20;BILBAO;2;1;B;768;417;4;413;8;405;351;124;76;51;2;15;58;77;2
BIZKAIA;20;BILBAO;2;2;U;659;350;0;350;7;343;309;94;91;49;2;20;49;37;1
BIZKAIA;20;BILBAO;2;3;U;722;396;1;395;4;391;326;123;60;49;2;12;54;89;2
BIZKAIA;20;BILBAO;2;4;U;657;370;1;369;7;362;287;126;34;60;3;21;47;71;0
BIZKAIA;20;BILBAO;2;5;A;657;353;6;347;9;338;304;93;61;20;0;13;73;76;2
BIZKAIA;20;BILBAO;2;5;B;634;331;2;329;3;326;303;80;72;30;5;3;46;90;0
BIZKAIA;20;BILBAO;2;6;U;1019;550;10;540;11;529;469;154;87;39;20;1;79;149;0
BIZKAIA;20;BILBAO;2;7;U;887;520;3;517;9;508;367;125;92;67;3;22;65;134;0
BIZKAIA;20;BILBAO;2;8;U;935;587;0;587;12;575;348;258;97;68;0;51;35;65;1
BIZKAIA;20;BILBAO;2;9;U;947;543;2;541;4;537;404;163;107;56;5;25;61;117;3
BIZKAIA;20;BILBAO;2;10;U;894;475;2;473;13;460;419;109;119;41;2;12;59;118;0
BIZKAIA;20;BILBAO;2;11;A;765;404;3;401;10;391;361;98;82;44;1;8;57;100;1
BIZKAIA;20;BILBAO;2;11;B;880;499;6;493;9;484;381;117;83;40;2;16;86;138;2
BIZKAIA;20;BILBAO;2;12;A;892;602;1;601;17;584;290;272;110;54;1;42;43;62;0
BIZKAIA;20;BILBAO;2;12;B;830;549;3;546;11;535;281;258;98;40;0;36;45;58;0
BIZKAIA;20;BILBAO;2;13;U;895;495;10;485;4;481;400;134;65;50;2;25;84;120;1
BIZKAIA;20;BILBAO;2;14;U;1064;589;2;587;15;572;475;194;83;41;1;12;82;156;3
BIZKAIA;20;BILBAO;2;15;A;600;389;0;389;5;384;211;184;70;37;2;37;33;21;0
BIZKAIA;20;BILBAO;2;15;B;621;426;1;425;16;409;195;211;63;33;1;38;34;29;0
BIZKAIA;20;BILBAO;2;16;U;1107;674;4;670;10;660;433;238;115;97;1;61;72;76;0
BIZKAIA;20;BILBAO;2;17;U;742;437;2;435;7;428;305;181;29;97;1;20;31;68;1
BIZKAIA;20;BILBAO;2;18;U;1091;843;2;841;11;830;248;239;132;63;2;44;83;265;2
BIZKAIA;20;BILBAO;2;19;A;733;389;0;389;8;381;344;124;75;52;5;13;47;65;0
BIZKAIA;20;BILBAO;2;19;B;803;444;1;443;7;436;359;142;92;44;4;20;52;82;0
BIZKAIA;20;BILBAO;2;20;A;616;332;2;330;6;324;284;92;47;50;3;15;36;80;1
BIZKAIA;20;BILBAO;2;20;B;609;309;2;307;2;305;300;85;49;48;0;13;43;66;1
BIZKAIA;20;BILBAO;2;21;U;1099;571;2;569;5;564;528;166;87;67;2;18;58;165;1
BIZKAIA;20;BILBAO;2;22;A;557;318;0;318;8;310;239;74;57;33;1;6;55;80;4
BIZKAIA;20;BILBAO;2;22;B;626;350;1;349;6;343;276;92;50;17;1;11;71;100;1
BIZKAIA;20;BILBAO;2;23;U;960;528;3;525;11;514;432;143;91;40;1;26;65;146;2
BIZKAIA;20;BILBAO;2;24;U;1059;706;6;700;12;688;353;204;170;40;2;44;82;144;2
BIZKAIA;20;BILBAO;2;25;A;685;454;2;452;8;444;231;191;103;41;0;29;32;45;3
BIZKAIA;20;BILBAO;2;25;B;669;445;0;445;9;436;224;183;90;34;0;31;50;46;2
BIZKAIA;20;BILBAO;2;26;A;738;452;0;452;4;448;286;151;77;67;3;18;52;80;0
BIZKAIA;20;BILBAO;2;26;B;664;418;0;418;7;411;246;152;80;56;0;17;39;66;1
BIZKAIA;20;BILBAO;2;27;U;973;533;2;531;19;512;440;210;78;62;5;45;52;59;1
BIZKAIA;20;BILBAO;2;28;U;713;364;1;363;4;359;349;127;47;55;0;20;48;59;3
BIZKAIA;20;BILBAO;2;29;A;642;368;0;368;6;362;274;107;72;29;2;19;41;92;0
BIZKAIA;20;BILBAO;2;29;B;641;350;1;349;12;337;291;88;73;33;0;10;35;97;1
BIZKAIA;20;BILBAO;2;30;U;1017;614;3;611;6;605;403;181;169;56;2;45;60;92;0
BIZKAIA;20;BILBAO;2;31;A;701;464;1;463;7;456;237;172;156;17;1;21;40;49;0
BIZKAIA;20;BILBAO;2;31;B;656;420;1;419;8;411;236;145;159;21;1;15;30;39;1
BIZKAIA;20;BILBAO;2;32;A;713;477;4;473;8;465;236;213;101;40;1;43;33;34;0
BIZKAIA;20;BILBAO;2;32;B;658;410;1;409;8;401;248;191;91;25;3;22;26;43;0
BIZKAIA;20;BILBAO;2;33;A;612;431;3;428;16;412;181;184;103;26;2;26;37;34;0
BIZKAIA;20;BILBAO;2;33;B;624;432;3;429;10;419;192;174;101;37;2;27;36;42;0
BIZKAIA;20;BILBAO;2;34;U;1031;618;1;617;11;606;413;249;114;69;3;38;48;83;2
BIZKAIA;20;BILBAO;2;35;U;567;380;4;376;12;364;187;158;79;32;0;25;38;31;1
BIZKAIA;20;BILBAO;3;1;U;568;331;2;329;0;329;237;125;61;13;0;23;35;72;0
BIZKAIA;20;BILBAO;3;2;U;935;477;3;474;9;465;458;116;64;47;2;34;69;133;0
BIZKAIA;20;BILBAO;3;3;A;554;249;0;249;5;244;305;32;26;23;0;10;42;111;0
BIZKAIA;20;BILBAO;3;3;B;673;351;1;350;1;349;322;57;40;34;0;8;51;157;2
BIZKAIA;20;BILBAO;3;4;U;709;362;8;354;4;350;347;63;40;37;0;11;44;154;1
BIZKAIA;20;BILBAO;3;5;A;706;334;0;334;8;326;372;60;44;38;2;15;42;124;1
BIZKAIA;20;BILBAO;3;5;B;635;325;3;322;0;322;310;47;55;49;3;17;37;113;1
BIZKAIA;20;BILBAO;3;6;U;1047;494;3;491;8;483;553;80;46;67;0;22;69;198;1
BIZKAIA;20;BILBAO;3;7;A;588;243;6;237;1;236;345;35;16;25;2;10;31;116;1
BIZKAIA;20;BILBAO;3;7;B;619;282;0;282;3;279;337;52;28;34;1;6;28;127;3
BIZKAIA;20;BILBAO;3;8;U;891;328;10;318;1;317;563;30;27;61;3;10;49;137;0
BIZKAIA;20;BILBAO;3;9;U;939;455;0;455;6;449;484;70;35;62;2;18;65;196;1
BIZKAIA;20;BILBAO;3;10;U;936;422;1;421;4;417;514;82;62;36;0;21;69;146;1
BIZKAIA;20;BILBAO;3;11;U;952;433;4;429;6;423;519;66;29;65;0;23;66;174;0
BIZKAIA;20;BILBAO;3;12;U;719;316;7;309;2;307;403;50;45;46;1;7;30;127;1
BIZKAIA;20;BILBAO;3;13;U;1071;711;0;711;16;695;360;179;150;74;10;31;87;163;1
BIZKAIA;20;BILBAO;3;14;A;808;496;2;494;11;483;312;163;107;50;2;25;49;87;0
BIZKAIA;20;BILBAO;3;14;B;861;528;1;527;5;522;333;153;106;52;2;30;60;119;0
BIZKAIA;20;BILBAO;3;15;A;667;294;8;286;5;281;373;70;32;46;1;7;32;91;2
BIZKAIA;20;BILBAO;3;15;B;612;279;2;277;5;272;333;68;26;38;1;10;46;82;1
BIZKAIA;20;BILBAO;3;16;A;1006;679;1;678;8;670;327;250;96;112;1;68;50;93;0
BIZKAIA;20;BILBAO;3;16;B;944;606;0;606;1;605;338;273;86;71;3;41;53;77;1
BIZKAIA;20;BILBAO;3;17;A;811;452;1;451;3;448;359;126;57;61;1;23;75;105;0
BIZKAIA;20;BILBAO;3;17;B;778;421;0;421;6;415;357;107;76;53;2;17;74;86;0
BIZKAIA;20;BILBAO;3;18;A;964;412;1;411;7;404;552;130;48;66;2;22;59;76;1
BIZKAIA;20;BILBAO;3;18;B;824;342;4;338;9;329;482;83;40;59;1;9;72;63;2
BIZKAIA;20;BILBAO;3;19;A;914;447;3;444;7;437;467;120;60;45;0;29;77;105;1
BIZKAIA;20;BILBAO;3;19;B;902;450;2;448;14;434;452;101;58;67;2;26;77;103;0
BIZKAIA;20;BILBAO;4;1;U;542;332;1;331;7;324;210;152;55;35;2;20;28;32;0
BIZKAIA;20;BILBAO;4;2;U;856;493;2;491;10;481;363;203;67;61;0;37;44;69;0
BIZKAIA;20;BILBAO;4;3;U;1037;657;1;656;16;640;380;260;152;57;0;50;50;71;0
BIZKAIA;20;BILBAO;4;4;U;577;372;1;371;7;364;205;179;80;25;0;34;23;23;0
BIZKAIA;20;BILBAO;4;5;U;1025;653;3;650;8;642;372;236;119;92;1;40;64;90;0
BIZKAIA;20;BILBAO;4;6;U;1111;658;2;656;16;640;453;246;125;87;0;40;53;89;0
BIZKAIA;20;BILBAO;4;7;U;631;380;0;380;6;374;251;135;65;47;0;21;48;58;0
BIZKAIA;20;BILBAO;4;8;A;652;389;2;387;5;382;263;130;63;69;0;27;34;59;0
BIZKAIA;20;BILBAO;4;8;B;651;376;1;375;13;362;275;117;62;44;3;21;46;69;0
BIZKAIA;20;BILBAO;4;9;A;666;430;0;430;10;420;236;172;52;64;1;35;42;54;0
BIZKAIA;20;BILBAO;4;9;B;654;415;1;414;5;409;239;181;49;56;0;32;33;57;1
BIZKAIA;20;BILBAO;4;10;A;912;566;2;564;11;553;346;185;101;75;0;29;71;92;0
BIZKAIA;20;BILBAO;4;10;B;860;498;4;494;8;486;362;153;95;72;0;31;60;74;1
BIZKAIA;20;BILBAO;4;11;U;570;351;1;350;3;347;219;147;48;45;1;31;31;44;0
BIZKAIA;20;BILBAO;4;12;A;825;518;4;514;10;504;307;165;87;84;1;47;48;72;0
BIZKAIA;20;BILBAO;4;12;B;918;583;4;579;8;571;335;190;115;90;0;30;58;88;0
BIZKAIA;20;BILBAO;4;13;A;618;405;1;404;6;398;213;154;58;56;0;26;37;66;1
BIZKAIA;20;BILBAO;4;13;B;644;408;3;405;7;398;236;141;81;62;1;26;43;44;0
BIZKAIA;20;BILBAO;4;14;U;1167;679;3;676;13;663;488;234;148;71;5;39;58;108;0
BIZKAIA;20;BILBAO;4;15;U;1051;575;2;573;6;567;476;193;112;72;0;29;66;94;1
BIZKAIA;20;BILBAO;4;16;U;946;571;2;569;3;566;375;212;119;77;2;25;36;95;0
BIZKAIA;20;BILBAO;4;17;U;926;587;2;585;15;570;339;229;76;84;0;29;52;99;1
BIZKAIA;20;BILBAO;4;18;U;902;518;1;517;9;508;384;161;103;51;2;31;62;96;2
BIZKAIA;20;BILBAO;4;19;U;1030;600;7;593;0;593;430;196;77;90;0;25;65;140;0
BIZKAIA;20;BILBAO;4;20;U;817;487;2;485;8;477;330;175;77;57;0;20;65;82;1
BIZKAIA;20;BILBAO;4;21;A;790;531;1;530;11;519;259;219;100;41;0;40;54;65;0
BIZKAIA;20;BILBAO;4;21;B;709;459;0;459;9;450;250;163;89;48;0;20;53;77;0
BIZKAIA;20;BILBAO;4;22;A;809;486;1;485;8;477;323;154;72;60;4;33;57;97;0
BIZKAIA;20;BILBAO;4;22;B;822;485;2;483;10;473;337;140;61;55;1;32;65;118;1
BIZKAIA;20;BILBAO;4;23;U;567;325;0;325;2;323;242;90;30;47;0;25;29;102;0
BIZKAIA;20;BILBAO;4;24;A;616;361;4;357;3;354;255;90;62;46;1;20;57;78;0
BIZKAIA;20;BILBAO;4;24;B;616;365;3;362;5;357;251;112;62;38;5;13;60;67;0
BIZKAIA;20;BILBAO;4;25;A;591;318;1;317;8;309;273;100;37;30;0;13;53;74;2
BIZKAIA;20;BILBAO;4;25;B;652;329;1;328;7;321;323;108;54;28;0;12;46;71;2
BIZKAIA;20;BILBAO;4;26;A;620;349;1;348;3;345;271;105;51;55;1;19;47;67;0
BIZKAIA;20;BILBAO;4;26;B;557;328;2;326;3;323;229;86;57;35;2;17;55;70;1
BIZKAIA;20;BILBAO;4;27;A;615;328;2;326;1;325;287;129;41;54;0;16;32;52;1
BIZKAIA;20;BILBAO;4;27;B;666;358;5;353;2;351;308;126;47;50;2;28;36;60;2
BIZKAIA;20;BILBAO;4;28;A;593;302;1;301;4;297;291;96;41;35;0;19;28;78;0
BIZKAIA;20;BILBAO;4;28;B;639;308;4;304;8;296;331;79;46;39;0;13;43;76;0
BIZKAIA;20;BILBAO;4;29;A;790;436;4;432;9;423;354;140;54;74;1;21;51;81;1
BIZKAIA;20;BILBAO;4;29;B;903;519;3;516;9;507;384;133;61;81;2;22;72;134;2
BIZKAIA;20;BILBAO;4;30;A;612;350;0;350;8;342;262;76;54;51;3;16;52;88;2
BIZKAIA;20;BILBAO;4;30;B;624;355;1;354;8;346;269;72;65;62;5;13;49;80;0
BIZKAIA;20;BILBAO;4;31;U;673;387;4;383;7;376;286;116;37;43;1;15;65;98;1
BIZKAIA;20;BILBAO;4;32;U;1114;567;1;566;4;562;547;135;70;73;2;22;68;192;0
BIZKAIA;20;BILBAO;4;33;A;788;405;2;403;8;395;383;97;64;51;2;14;56;111;0
BIZKAIA;20;BILBAO;4;33;B;862;440;3;437;6;431;422;107;63;37;0;16;71;136;1
BIZKAIA;20;BILBAO;4;34;U;629;359;0;359;5;354;270;85;42;56;1;20;61;89;0
BIZKAIA;20;BILBAO;4;35;U;646;330;0;330;6;324;316;61;43;66;2;21;37;93;1
BIZKAIA;20;BILBAO;4;36;A;627;343;1;342;4;338;284;82;40;60;6;13;39;98;0
BIZKAIA;20;BILBAO;4;36;B;621;325;1;324;8;316;296;75;48;42;2;8;63;78;0
BIZKAIA;20;BILBAO;4;37;A;846;485;1;484;6;478;361;157;67;60;2;32;58;99;3
BIZKAIA;20;BILBAO;4;37;B;862;454;2;452;7;445;408;131;58;59;3;22;63;108;1
BIZKAIA;20;BILBAO;4;38;U;777;395;2;393;3;390;382;120;58;64;1;25;44;78;0
BIZKAIA;20;BILBAO;5;1;A;590;369;0;369;5;364;221;148;73;54;3;26;24;36;0
BIZKAIA;20;BILBAO;5;1;B;619;373;0;373;3;370;246;112;79;85;0;28;26;39;1
BIZKAIA;20;BILBAO;5;2;U;814;451;2;449;4;445;363;171;62;83;0;28;45;55;1
BIZKAIA;20;BILBAO;5;3;A;745;464;4;460;4;456;281;158;79;72;1;38;50;58;0
BIZKAIA;20;BILBAO;5;3;B;682;398;1;397;7;390;284;130;65;67;0;34;48;46;0
BIZKAIA;20;BILBAO;5;4;A;868;493;5;488;13;475;375;205;64;70;0;42;48;46;0
BIZKAIA;20;BILBAO;5;4;B;797;431;1;430;5;425;366;143;69;72;0;22;45;74;0
BIZKAIA;20;BILBAO;5;5;U;849;538;1;537;7;530;311;156;118;101;2;44;54;55;0
BIZKAIA;20;BILBAO;5;6;U;890;536;2;534;6;528;354;177;59;146;2;46;39;59;0
BIZKAIA;20;BILBAO;5;7;U;624;376;2;374;8;366;248;120;58;71;0;32;49;36;0
BIZKAIA;20;BILBAO;5;8;U;1192;734;6;728;8;720;458;247;121;164;0;78;48;62;0
BIZKAIA;20;BILBAO;5;9;A;902;543;7;536;18;518;359;210;57;86;2;51;61;49;2
BIZKAIA;20;BILBAO;5;9;B;828;480;1;479;7;472;348;136;82;89;4;39;64;58;0
BIZKAIA;20;BILBAO;5;10;U;1032;600;3;597;0;597;432;200;87;117;1;43;67;81;1
BIZKAIA;20;BILBAO;5;11;U;1071;617;2;615;10;605;454;224;100;103;1;47;57;73;0
BIZKAIA;20;BILBAO;5;12;A;737;400;1;399;6;393;337;165;37;67;0;28;57;39;0
BIZKAIA;20;BILBAO;5;12;B;736;399;0;399;11;388;337;144;58;66;0;33;46;40;1
BIZKAIA;20;BILBAO;5;13;U;733;441;9;432;5;427;292;161;61;87;0;33;29;56;0
BIZKAIA;20;BILBAO;5;14;U;920;652;0;652;8;644;268;302;110;83;0;55;49;43;2
BIZKAIA;20;BILBAO;5;15;A;722;419;7;412;8;404;303;135;64;68;0;32;47;57;1
BIZKAIA;20;BILBAO;5;15;B;684;404;4;400;0;400;280;153;63;68;0;39;28;49;0
BIZKAIA;20;BILBAO;5;16;A;652;387;2;385;5;380;265;131;73;58;0;19;37;62;0
BIZKAIA;20;BILBAO;5;16;B;575;295;0;295;6;289;280;87;56;44;1;11;30;60;0
BIZKAIA;20;BILBAO;5;17;A;563;294;0;294;6;288;269;70;51;50;0;21;37;59;0
BIZKAIA;20;BILBAO;5;17;B;626;325;0;325;8;317;301;87;54;32;3;11;41;87;2
BIZKAIA;20;BILBAO;5;18;U;1028;505;1;504;4;500;523;191;42;120;0;22;46;79;0
BIZKAIA;20;BILBAO;5;19;U;890;472;1;471;6;465;418;151;108;75;2;31;35;62;1
BIZKAIA;20;BILBAO;5;20;U;639;350;2;348;2;346;289;102;74;65;0;18;42;44;1
BIZKAIA;20;BILBAO;5;21;A;613;327;1;326;3;323;286;96;45;54;1;23;29;75;0
BIZKAIA;20;BILBAO;5;21;B;669;390;0;390;6;384;279;109;53;76;1;32;41;69;3
BIZKAIA;20;BILBAO;5;22;U;589;338;1;337;5;332;251;80;63;78;1;7;36;67;0
BIZKAIA;20;BILBAO;5;23;U;579;279;2;277;2;275;300;83;56;60;1;14;18;42;1
BIZKAIA;20;BILBAO;5;24;A;852;465;0;465;6;459;387;148;93;55;1;25;48;89;0
BIZKAIA;20;BILBAO;5;24;B;842;471;7;464;6;458;371;150;100;49;0;25;42;90;2
BIZKAIA;20;BILBAO;5;25;U;1165;569;2;567;9;558;596;174;59;100;1;22;79;119;4
BIZKAIA;20;BILBAO;5;26;U;1047;427;0;427;3;424;620;127;74;63;2;15;49;94;0
BIZKAIA;20;BILBAO;5;27;U;536;227;1;226;2;224;309;86;25;29;2;8;25;46;3
BIZKAIA;20;BILBAO;5;28;U;1172;732;9;723;16;707;440;235;152;67;2;51;67;132;1
BIZKAIA;20;BILBAO;5;29;U;629;339;0;339;7;332;290;96;40;48;0;21;68;59;0
BIZKAIA;20;BILBAO;5;30;U;962;390;0;390;1;389;572;89;56;131;2;19;27;61;4
BIZKAIA;20;BILBAO;5;31;U;1094;596;4;592;20;572;498;202;85;106;1;38;49;89;2
BIZKAIA;20;BILBAO;5;32;A;938;588;3;585;1;584;350;211;79;83;2;32;87;89;1
BIZKAIA;20;BILBAO;5;32;B;865;549;2;547;9;538;316;196;106;55;4;38;58;81;0
BIZKAIA;20;BILBAO;5;33;U;660;374;3;371;5;366;286;115;31;75;0;24;43;78;0
BIZKAIA;20;BILBAO;5;34;U;841;470;1;469;11;458;371;206;25;78;0;28;43;77;1
BIZKAIA;20;BILBAO;5;35;A;811;444;4;440;8;432;367;150;70;51;2;13;53;93;0
BIZKAIA;20;BILBAO;5;35;B;776;431;1;430;10;420;345;157;72;51;2;19;55;62;2
BIZKAIA;20;BILBAO;5;36;A;874;449;1;448;9;439;425;144;75;66;0;18;36;96;4
BIZKAIA;20;BILBAO;5;36;B;889;469;0;469;2;467;420;149;93;55;2;22;53;93;0
BIZKAIA;20;BILBAO;5;37;U;1056;583;2;581;10;571;473;192;59;68;0;35;66;151;0
BIZKAIA;20;BILBAO;5;38;A;727;395;6;389;5;384;332;132;31;73;1;11;40;93;3
BIZKAIA;20;BILBAO;5;38;B;633;348;1;347;3;344;285;131;33;41;0;7;36;94;2
BIZKAIA;20;BILBAO;5;39;U;664;374;2;372;2;370;290;156;29;34;0;20;45;85;1
BIZKAIA;20;BILBAO;5;40;A;612;320;4;316;4;312;292;141;33;42;1;15;24;56;0
BIZKAIA;20;BILBAO;5;40;B;594;304;0;304;4;300;290;130;26;27;0;11;35;71;0
BIZKAIA;20;BILBAO;6;1;U;999;706;2;704;6;698;293;210;333;36;1;42;28;46;2
BIZKAIA;20;BILBAO;6;2;A;763;546;1;545;8;537;217;232;215;15;0;37;16;22;0
BIZKAIA;20;BILBAO;6;2;B;831;602;0;602;23;579;229;227;229;21;0;41;26;34;1
BIZKAIA;20;BILBAO;6;3;U;1075;750;0;750;19;731;325;294;233;35;3;70;39;56;1
BIZKAIA;20;BILBAO;6;4;U;823;564;0;564;8;556;259;225;159;33;0;62;28;49;0
BIZKAIA;20;BILBAO;6;5;U;979;701;2;699;11;688;278;255;232;40;1;46;50;64;0
BIZKAIA;20;BILBAO;6;6;U;779;527;2;525;10;515;252;241;112;50;1;28;28;55;0
BIZKAIA;20;BILBAO;6;7;A;775;558;2;556;14;542;217;199;223;24;1;47;15;33;0
BIZKAIA;20;BILBAO;6;7;B;620;430;2;428;11;417;190;134;196;11;1;33;18;23;1
BIZKAIA;20;BILBAO;6;8;U;583;420;0;420;6;414;163;161;154;18;0;40;19;22;0
BIZKAIA;20;BILBAO;6;9;A;672;449;2;447;4;443;223;154;171;24;0;33;33;28;0
BIZKAIA;20;BILBAO;6;9;B;674;474;2;472;4;468;200;190;173;22;1;33;25;24;0
BIZKAIA;20;BILBAO;6;10;U;852;537;0;537;9;528;315;186;150;34;0;48;56;53;1
BIZKAIA;20;BILBAO;6;11;U;635;430;0;430;16;414;205;135;209;10;1;15;19;25;0
BIZKAIA;20;BILBAO;6;12;U;783;550;1;549;7;542;233;165;219;25;0;37;34;61;1
BIZKAIA;20;BILBAO;6;13;A;769;491;0;491;5;486;278;184;155;38;0;52;30;27;0
BIZKAIA;20;BILBAO;6;13;B;732;481;0;481;10;471;251;191;140;40;0;20;37;43;0
BIZKAIA;20;BILBAO;6;14;U;537;396;2;394;6;388;141;135;187;10;1;30;10;15;0
BIZKAIA;20;BILBAO;6;15;A;815;553;0;553;10;543;262;201;216;27;0;39;20;40;0
BIZKAIA;20;BILBAO;6;15;B;869;594;1;593;19;574;275;219;210;44;1;47;19;34;0
BIZKAIA;20;BILBAO;6;16;A;613;430;0;430;10;420;183;146;205;9;1;23;10;26;0
BIZKAIA;20;BILBAO;6;16;B;575;404;1;403;9;394;171;127;206;4;0;28;10;18;1
BIZKAIA;20;BILBAO;6;17;A;801;573;1;572;11;561;228;194;245;15;2;46;16;43;0
BIZKAIA;20;BILBAO;6;17;B;793;547;3;544;10;534;246;171;238;24;2;40;26;33;0
BIZKAIA;20;BILBAO;6;18;U;784;574;5;569;8;561;210;179;268;15;0;59;13;24;3
BIZKAIA;20;BILBAO;6;19;U;567;407;1;406;5;401;160;107;192;11;1;35;20;35;0
BIZKAIA;20;BILBAO;6;20;U;854;580;4;576;15;561;274;216;236;28;0;36;16;29;0
BIZKAIA;20;BILBAO;6;21;A;617;390;0;390;5;385;227;139;133;28;1;33;17;34;0
BIZKAIA;20;BILBAO;6;21;B;628;435;0;435;5;430;193;155;184;27;0;24;15;25;0
BIZKAIA;20;BILBAO;6;22;U;816;531;0;531;12;519;285;246;97;43;1;45;41;46;0
BIZKAIA;20;BILBAO;6;23;U;830;532;0;532;7;525;298;227;159;38;1;39;29;32;0
BIZKAIA;20;BILBAO;6;24;U;724;482;0;482;4;478;242;209;112;35;0;35;45;42;0
BIZKAIA;20;BILBAO;6;25;U;1084;705;1;704;12;692;379;225;233;54;0;57;44;79;0
BIZKAIA;20;BILBAO;6;26;A;591;410;0;410;4;406;181;139;156;17;1;51;25;17;0
BIZKAIA;20;BILBAO;6;26;B;623;426;0;426;6;420;197;139;178;22;0;36;16;29;0
BIZKAIA;20;BILBAO;6;27;U;646;458;4;454;7;447;188;158;199;16;0;20;26;27;1
BIZKAIA;20;BILBAO;6;28;U;847;554;0;554;16;538;293;186;213;32;0;45;27;35;0
BIZKAIA;20;BILBAO;6;29;U;1144;782;0;782;12;770;362;295;260;31;1;55;55;73;0
BIZKAIA;20;BILBAO;6;30;U;834;497;2;495;9;486;337;136;134;56;2;33;53;70;2
BIZKAIA;20;BILBAO;6;31;U;981;680;2;678;7;671;301;262;213;30;3;45;37;79;2
BIZKAIA;20;BILBAO;6;32;U;684;519;1;518;7;511;165;194;196;18;1;41;16;45;0
BIZKAIA;20;BILBAO;6;33;U;972;650;2;648;18;630;322;250;207;40;0;45;43;44;1
BIZKAIA;20;BILBAO;6;34;U;878;512;1;511;4;507;366;184;134;49;1;28;43;68;0
BIZKAIA;20;BILBAO;6;35;A;686;449;3;446;8;438;237;162;116;27;2;42;38;49;2
BIZKAIA;20;BILBAO;6;35;B;663;449;2;447;9;438;214;160;150;21;0;23;32;52;0
BIZKAIA;20;BILBAO;6;36;A;568;402;1;401;14;387;166;150;134;28;0;21;23;30;1
BIZKAIA;20;BILBAO;6;36;B;630;397;1;396;11;385;233;164;110;24;0;33;14;38;2
BIZKAIA;20;BILBAO;6;37;U;1184;835;2;833;14;819;349;337;222;55;3;64;56;81;1
BIZKAIA;20;BILBAO;6;38;U;964;681;0;681;15;666;283;253;259;36;2;43;26;46;1
BIZKAIA;20;BILBAO;6;39;A;742;523;2;521;7;514;219;191;195;20;1;41;18;48;0
BIZKAIA;20;BILBAO;6;39;B;754;528;2;526;5;521;226;217;184;25;1;35;18;41;0
BIZKAIA;20;BILBAO;6;40;U;579;436;1;435;10;425;143;173;120;32;3;38;20;39;0
BIZKAIA;20;BILBAO;6;41;U;1129;750;4;746;15;731;379;277;245;47;2;46;36;78;0
BIZKAIA;20;BILBAO;6;42;U;1046;677;4;673;10;663;369;226;224;78;1;37;46;51;0
BIZKAIA;20;BILBAO;6;43;U;981;580;4;576;3;573;401;205;116;68;2;30;56;95;1
BIZKAIA;20;BILBAO;6;44;U;919;567;3;564;9;555;352;204;160;32;0;34;47;77;1
BIZKAIA;20;BILBAO;6;45;A;590;376;1;375;3;372;214;140;126;26;0;33;19;28;0
BIZKAIA;20;BILBAO;6;45;B;590;405;1;404;12;392;185;158;137;22;2;21;26;26;0
BIZKAIA;20;BILBAO;6;46;U;1103;756;7;749;12;737;347;243;252;49;1;68;39;84;1
BIZKAIA;20;BILBAO;6;47;U;594;394;2;392;5;387;200;159;116;14;2;19;18;59;0
BIZKAIA;20;BILBAO;6;48;U;692;421;4;417;8;409;271;151;99;31;0;39;28;61;0
BIZKAIA;20;BILBAO;7;1;U;1161;750;3;747;18;729;411;245;255;42;0;44;52;91;0
BIZKAIA;20;BILBAO;7;2;U;862;553;3;550;15;535;309;193;146;44;0;37;48;66;1
BIZKAIA;20;BILBAO;7;3;A;670;418;0;418;10;408;252;161;117;37;2;22;32;37;0
BIZKAIA;20;BILBAO;7;3;B;665;394;4;390;6;384;271;124;111;28;2;20;51;48;0
BIZKAIA;20;BILBAO;7;4;U;670;335;2;333;6;327;335;119;70;39;0;17;31;51;0
BIZKAIA;20;BILBAO;7;5;U;912;605;6;599;13;586;307;192;161;40;3;27;46;115;2
BIZKAIA;20;BILBAO;7;6;A;733;421;2;419;5;414;312;156;97;37;0;30;33;61;0
BIZKAIA;20;BILBAO;7;6;B;773;467;0;467;3;464;306;156;111;36;1;33;58;68;1
BIZKAIA;20;BILBAO;7;7;U;754;518;4;514;4;510;236;188;178;31;1;38;35;39;0
BIZKAIA;20;BILBAO;7;8;U;900;575;3;572;11;561;325;228;160;29;4;34;38;66;2
BIZKAIA;20;BILBAO;7;9;U;556;328;0;328;8;320;228;116;90;21;2;16;29;45;1
BIZKAIA;20;BILBAO;7;10;U;773;457;1;456;8;448;316;159;106;37;0;53;37;55;1
BIZKAIA;20;BILBAO;7;11;U;675;421;1;420;5;415;254;156;117;16;1;46;24;55;0
BIZKAIA;20;BILBAO;7;12;A;678;472;1;471;9;462;206;176;189;8;2;23;15;49;0
BIZKAIA;20;BILBAO;7;12;B;612;414;0;414;11;403;198;127;202;12;5;21;19;17;0
BIZKAIA;20;BILBAO;7;13;U;938;507;1;506;7;499;431;177;90;48;0;39;55;90;0
BIZKAIA;20;BILBAO;7;14;U;833;479;3;476;10;466;354;169;122;52;2;32;43;46;0
BIZKAIA;20;BILBAO;7;15;U;810;448;0;448;3;445;362;155;87;68;1;35;40;58;1
BIZKAIA;20;BILBAO;7;16;U;872;501;1;500;9;491;371;177;99;43;1;29;47;95;0
BIZKAIA;20;BILBAO;7;17;U;1073;614;5;609;13;596;459;166;126;63;4;35;82;120;0
BIZKAIA;20;BILBAO;7;18;U;747;439;0;439;5;434;308;183;60;49;1;37;32;71;1
BIZKAIA;20;BILBAO;7;19;U;952;502;1;501;13;488;450;155;91;62;1;13;75;89;2
BIZKAIA;20;BILBAO;7;20;U;588;332;2;330;5;325;256;98;59;62;1;18;43;42;2
BIZKAIA;20;BILBAO;7;21;U;1013;629;2;627;10;617;384;160;111;61;2;30;85;167;1
BIZKAIA;20;BILBAO;7;22;A;918;531;0;531;12;519;387;150;85;71;0;26;88;98;1
BIZKAIA;20;BILBAO;7;22;B;968;527;6;521;10;511;441;160;83;67;0;21;83;95;2
BIZKAIA;20;BILBAO;7;23;A;695;338;2;336;3;333;357;93;42;67;1;8;46;74;2
BIZKAIA;20;BILBAO;7;23;B;622;287;3;284;0;284;335;87;40;52;0;10;37;57;1
BIZKAIA;20;BILBAO;7;24;A;559;291;0;291;6;285;268;87;49;38;1;7;44;59;0
BIZKAIA;20;BILBAO;7;24;B;609;306;3;303;6;297;303;83;38;34;0;15;53;73;1
BIZKAIA;20;BILBAO;7;25;U;637;374;1;373;8;365;263;115;65;45;2;16;43;77;2
BIZKAIA;20;BILBAO;7;26;A;707;411;3;408;4;404;296;143;70;32;0;20;61;78;0
BIZKAIA;20;BILBAO;7;26;B;695;386;5;381;5;376;309;148;83;37;0;10;45;53;0
BIZKAIA;20;BILBAO;7;27;A;764;418;1;417;8;409;346;93;70;48;2;18;72;106;0
BIZKAIA;20;BILBAO;7;27;B;736;433;2;431;3;428;303;94;87;41;0;22;86;98;0
BIZKAIA;20;BILBAO;7;28;U;1046;483;15;468;2;466;563;136;87;63;1;6;56;117;0
BIZKAIA;20;BILBAO;7;29;A;601;289;0;289;1;288;312;64;49;27;3;14;47;84;0
BIZKAIA;20;BILBAO;7;29;B;635;327;4;323;3;320;308;74;62;31;4;11;62;76;0
BIZKAIA;20;BILBAO;7;30;U;1069;568;2;566;6;560;501;161;84;67;0;22;96;129;1
BIZKAIA;20;BILBAO;7;31;U;730;392;2;390;8;382;338;104;62;47;4;23;45;97;0
BIZKAIA;20;BILBAO;7;32;A;677;357;8;349;5;344;320;96;70;22;0;12;60;84;0
BIZKAIA;20;BILBAO;7;32;B;771;421;7;414;3;411;350;117;89;36;0;18;69;82;0
BIZKAIA;20;BILBAO;7;33;U;1131;622;12;610;5;605;509;157;81;41;6;9;94;215;2
BIZKAIA;20;BILBAO;7;34;U;1024;525;3;522;6;516;499;164;61;87;3;32;88;81;0
BIZKAIA;20;BILBAO;7;35;A;844;457;2;455;12;443;387;99;82;45;2;17;68;130;0
BIZKAIA;20;BILBAO;7;35;B;812;421;4;417;11;406;391;111;65;35;5;14;61;113;2
BIZKAIA;20;BILBAO;7;36;U;961;479;15;464;6;458;482;124;45;43;1;5;74;166;0
BIZKAIA;20;BILBAO;7;37;U;865;412;4;408;10;398;453;72;44;35;3;6;74;164;0
BIZKAIA;20;BILBAO;7;38;A;670;320;4;316;6;310;350;78;51;29;0;8;63;80;1
BIZKAIA;20;BILBAO;7;38;B;711;363;0;363;6;357;348;104;47;27;1;9;66;102;1
BIZKAIA;20;BILBAO;7;39;U;751;351;1;350;3;347;400;75;27;22;2;8;38;167;8
BIZKAIA;20;BILBAO;7;40;U;973;460;12;448;4;444;513;119;36;26;1;14;88;160;0
BIZKAIA;20;BILBAO;8;1;U;1211;629;8;621;4;617;582;199;71;85;0;27;87;146;2
BIZKAIA;20;BILBAO;8;2;A;767;410;1;409;7;402;357;147;60;49;0;12;57;77;0
BIZKAIA;20;BILBAO;8;2;B;870;470;2;468;10;458;400;170;51;47;1;29;60;99;1
BIZKAIA;20;BILBAO;8;3;A;595;336;3;333;2;331;259;95;37;54;1;15;53;73;3
BIZKAIA;20;BILBAO;8;3;B;656;393;8;385;3;382;263;109;45;69;2;24;56;77;0
BIZKAIA;20;BILBAO;8;4;A;675;403;6;397;2;395;272;122;52;36;3;8;54;118;2
BIZKAIA;20;BILBAO;8;4;B;764;418;5;413;2;411;346;116;67;43;0;13;58;114;0
BIZKAIA;20;BILBAO;8;5;A;604;334;3;331;6;325;270;95;38;51;1;17;48;74;1
BIZKAIA;20;BILBAO;8;5;B;627;366;4;362;3;359;261;107;51;57;0;12;57;75;0
BIZKAIA;20;BILBAO;8;6;U;1144;573;2;571;11;560;571;130;68;62;2;19;114;165;0
BIZKAIA;20;BILBAO;8;7;U;1142;567;2;565;9;556;575;94;114;74;1;28;83;162;0
BIZKAIA;20;BILBAO;8;8;U;919;504;6;498;7;491;415;143;50;86;2;32;67;111;0
BIZKAIA;20;BILBAO;8;9;U;862;482;10;472;9;463;380;153;73;55;2;29;49;101;1
BIZKAIA;20;BILBAO;8;10;U;814;462;2;460;7;453;352;140;69;49;0;18;55;121;1
BIZKAIA;20;BILBAO;8;11;U;515;282;0;282;3;279;233;97;53;34;2;11;25;57;0
BIZKAIA;20;BILBAO;8;12;U;1134;712;5;707;6;701;422;366;57;129;1;29;51;68;0
BIZKAIA;20;BILBAO;8;13;A;534;258;0;258;2;256;276;81;56;26;1;5;33;53;1
BIZKAIA;20;BILBAO;8;13;B;728;319;0;319;2;317;409;83;74;33;2;18;46;60;1
BIZKAIA;20;BILBAO;8;14;A;347;164;0;164;2;162;183;37;55;7;0;2;21;37;3
BIZKAIA;20;BILBAO;8;14;B;581;315;1;314;4;310;266;97;48;24;1;17;50;73;0
BIZKAIA;20;BILBAO;8;15;U;990;584;3;581;7;574;406;175;90;62;1;32;101;112;1
BIZKAIA;20;BILBAO;8;16;U;698;419;0;419;5;414;279;161;148;17;1;25;24;34;4
BIZKAIA;20;BILBAO;8;17;U;561;367;0;367;6;361;194;135;105;41;0;26;20;34;0
BIZKAIA;20;BILBAO;8;18;U;1141;777;3;774;15;759;364;316;300;20;2;40;36;44;1
BIZKAIA;20;BILBAO;8;19;A;828;532;1;531;7;524;296;167;148;41;0;37;48;83;0
BIZKAIA;20;BILBAO;8;19;B;827;514;2;512;6;506;313;193;137;46;1;21;35;72;1
BIZKAIA;20;BILBAO;8;20;A;751;458;3;455;6;449;293;166;109;45;1;38;30;60;0
BIZKAIA;20;BILBAO;8;20;B;811;526;4;522;7;515;285;188;146;52;4;33;38;54;0
BIZKAIA;20;BILBAO;8;21;U;910;528;0;528;0;528;382;222;111;43;0;29;44;79;0
BIZKAIA;20;BILBAO;8;22;A;815;518;0;518;5;513;297;186;134;44;3;38;37;69;2
BIZKAIA;20;BILBAO;8;22;B;885;546;3;543;8;535;339;210;133;38;1;33;50;67;3
BIZKAIA;20;BILBAO;8;23;A;648;364;2;362;5;357;284;116;81;43;0;19;31;67;0
BIZKAIA;20;BILBAO;8;23;B;751;393;0;393;13;380;358;102;81;40;1;20;51;85;0
BIZKAIA;20;BILBAO;8;24;A;921;553;3;550;15;535;368;189;121;41;0;37;57;89;1
BIZKAIA;20;BILBAO;8;24;B;900;534;0;534;9;525;366;212;132;42;4;22;44;67;2
BIZKAIA;21;BUSTURIA;1;1;U;592;456;5;451;1;450;136;268;9;92;0;71;4;5;1
BIZKAIA;21;BUSTURIA;1;2;U;809;532;0;532;5;527;277;191;18;164;0;66;19;68;1
BIZKAIA;22;KARRANTZA HARANA / VALLE DE CARRANZA;1;1;U;1359;760;2;758;3;755;599;436;94;91;0;38;21;75;0
BIZKAIA;22;KARRANTZA HARANA / VALLE DE CARRANZA;1;2;U;569;267;2;265;1;264;302;173;16;41;0;12;1;20;1
BIZKAIA;22;KARRANTZA HARANA / VALLE DE CARRANZA;2;1;U;684;378;1;377;2;375;306;200;24;52;0;24;8;66;1
BIZKAIA;23;ARTEA;1;1;U;530;433;7;426;1;425;97;198;43;105;0;74;2;3;0
BIZKAIA;24;ZEANURI;1;1;A;551;423;1;422;1;421;128;213;24;79;0;102;2;1;0
BIZKAIA;24;ZEANURI;1;1;B;431;322;1;321;3;318;109;160;18;39;0;95;4;2;0
BIZKAIA;25;ZEBERIO;1;1;A;352;238;1;237;1;236;114;129;5;83;0;12;4;3;0
BIZKAIA;25;ZEBERIO;1;1;B;456;358;0;358;1;357;98;257;5;76;0;9;3;6;1
BIZKAIA;26;DIMA;1;1;U;891;741;5;736;8;728;150;306;36;324;0;58;2;2;0
BIZKAIA;27;DURANGO;1;1;U;732;479;3;476;7;469;253;187;84;84;3;20;44;47;0
BIZKAIA;27;DURANGO;1;2;U;696;491;5;486;4;482;205;236;81;50;0;50;36;28;1
BIZKAIA;27;DURANGO;1;3;U;911;626;0;626;12;614;285;315;95;79;0;28;37;59;1
BIZKAIA;27;DURANGO;2;1;U;963;625;2;623;6;617;338;273;99;109;0;40;27;68;1
BIZKAIA;27;DURANGO;2;2;A;688;463;0;463;6;457;225;182;52;83;0;39;34;66;1
BIZKAIA;27;DURANGO;2;2;B;606;375;0;375;7;368;231;137;53;53;1;14;37;71;2
BIZKAIA;27;DURANGO;2;3;U;600;378;4;374;11;363;222;161;50;53;1;26;25;46;1
BIZKAIA;27;DURANGO;3;1;A;649;441;0;441;5;436;208;164;51;108;1;29;47;35;1
BIZKAIA;27;DURANGO;3;1;B;490;315;0;315;10;305;175;130;50;59;1;16;23;26;0
BIZKAIA;27;DURANGO;3;2;U;638;331;1;330;1;329;307;99;32;56;0;32;27;82;1
BIZKAIA;27;DURANGO;3;3;U;819;514;1;513;4;509;305;155;71;73;0;24;56;129;1
BIZKAIA;27;DURANGO;4;1;A;762;484;2;482;5;477;278;189;60;100;6;38;33;50;1
BIZKAIA;27;DURANGO;4;1;B;616;376;4;372;4;368;240;131;70;47;0;20;36;61;3
BIZKAIA;27;DURANGO;4;2;A;672;431;0;431;2;429;241;192;52;70;1;45;30;38;1
BIZKAIA;27;DURANGO;4;2;B;594;377;0;377;1;376;217;159;64;49;0;31;25;47;1
BIZKAIA;27;DURANGO;4;3;A;1008;582;3;579;8;571;426;240;75;90;3;38;38;86;1
BIZKAIA;27;DURANGO;4;3;B;795;444;4;440;7;433;351;146;60;60;0;32;46;88;1
BIZKAIA;27;DURANGO;4;4;A;1070;663;3;660;9;651;407;277;91;125;0;63;38;57;0
BIZKAIA;27;DURANGO;4;4;B;892;559;4;555;8;547;333;215;86;94;3;45;38;66;0
BIZKAIA;27;DURANGO;4;5;U;785;495;0;495;12;483;290;206;77;68;3;44;39;46;0
BIZKAIA;27;DURANGO;5;1;U;716;513;2;511;12;499;203;262;120;50;2;43;9;11;2
BIZKAIA;27;DURANGO;5;2;U;1036;668;4;664;14;650;368;250;56;127;0;31;93;93;0
BIZKAIA;27;DURANGO;5;3;A;954;650;4;646;9;637;304;279;81;111;3;57;35;71;0
BIZKAIA;27;DURANGO;5;3;B;814;542;1;541;10;531;272;240;73;71;3;38;28;77;1
BIZKAIA;28;EA;1;1;U;708;537;1;536;1;535;171;283;11;149;0;84;3;5;0
BIZKAIA;29;ETXEBARRI;1;1;A;651;428;0;428;2;426;223;155;57;53;1;64;31;65;0
BIZKAIA;29;ETXEBARRI;1;1;B;612;348;0;348;5;343;264;130;43;35;2;47;20;66;0
BIZKAIA;29;ETXEBARRI;1;1;C;619;387;1;386;6;380;232;116;46;56;0;53;35;74;0
BIZKAIA;29;ETXEBARRI;1;2;A;931;441;1;440;5;435;490;111;52;34;3;22;92;119;2
BIZKAIA;29;ETXEBARRI;1;2;B;991;513;3;510;5;505;478;143;52;34;4;19;92;160;1
BIZKAIA;29;ETXEBARRI;1;3;A;675;314;1;313;2;311;361;78;27;16;1;11;42;134;2
BIZKAIA;29;ETXEBARRI;1;3;B;620;288;4;284;1;283;332;70;34;16;0;14;37;112;0
BIZKAIA;30;ETXEBARRIA;1;1;U;635;386;3;383;6;377;249;161;3;174;0;30;6;3;0
BIZKAIA;31;ELANTXOBE;1;1;U;448;361;2;359;2;357;87;195;3;110;0;37;6;6;0
BIZKAIA;32;ELORRIO;1;1;A;902;583;4;579;10;569;319;198;41;142;3;36;42;107;0
BIZKAIA;32;ELORRIO;1;1;B;626;396;5;391;3;388;230;164;36;73;5;26;23;61;0
BIZKAIA;32;ELORRIO;1;2;A;913;597;7;590;5;585;316;210;65;133;3;44;35;94;1
BIZKAIA;32;ELORRIO;1;2;B;700;447;5;442;6;436;253;143;31;99;3;36;37;81;6
BIZKAIA;32;ELORRIO;1;3;A;937;626;5;621;1;620;311;234;51;146;1;51;43;94;0
BIZKAIA;32;ELORRIO;1;3;B;652;430;5;425;2;423;222;140;51;98;0;25;36;73;0
BIZKAIA;32;ELORRIO;1;4;U;722;515;6;509;5;504;207;258;27;121;0;37;16;45;0
BIZKAIA;32;ELORRIO;1;5;U;657;466;1;465;9;456;191;215;27;127;0;43;16;28;0
BIZKAIA;33;ERE?O;1;1;U;232;163;1;162;3;159;69;95;6;39;0;16;2;1;0
BIZKAIA;34;ERMUA;1;1;A;644;379;0;379;3;376;265;65;58;65;2;23;67;96;0
BIZKAIA;34;ERMUA;1;1;B;642;360;1;359;3;356;282;58;69;49;2;26;48;104;0
BIZKAIA;34;ERMUA;1;2;A;614;351;2;349;6;343;263;62;71;36;5;13;51;105;0
BIZKAIA;34;ERMUA;1;2;B;524;285;5;280;2;278;239;41;76;10;4;10;36;101;0
BIZKAIA;34;ERMUA;1;3;A;569;298;0;298;6;292;271;51;61;19;2;2;51;105;1
BIZKAIA;34;ERMUA;1;3;B;624;330;0;330;5;325;294;52;68;17;6;6;57;116;3
BIZKAIA;34;ERMUA;1;3;C;566;262;0;262;1;261;304;35;57;23;0;3;42;98;3
BIZKAIA;34;ERMUA;1;4;A;444;272;0;272;5;267;172;65;70;31;1;22;34;42;2
BIZKAIA;34;ERMUA;1;4;B;396;261;0;261;6;255;135;44;72;36;1;13;38;51;0
BIZKAIA;34;ERMUA;1;5;A;503;319;0;319;3;316;184;75;67;28;2;19;46;79;0
BIZKAIA;34;ERMUA;1;5;B;501;292;2;290;4;286;209;58;66;45;0;17;33;67;0
BIZKAIA;34;ERMUA;1;6;A;636;345;0;345;6;339;291;59;71;24;7;20;58;100;0
BIZKAIA;34;ERMUA;1;6;B;626;348;3;345;3;342;278;40;64;27;1;10;68;129;3
BIZKAIA;34;ERMUA;1;6;C;590;298;1;297;3;294;292;40;71;20;3;9;42;108;1
BIZKAIA;34;ERMUA;1;7;A;535;317;1;316;1;315;218;31;72;36;1;17;44;113;1
BIZKAIA;34;ERMUA;1;7;B;508;302;3;299;8;291;206;40;46;27;2;20;36;119;1
BIZKAIA;34;ERMUA;1;7;C;518;309;5;304;9;295;209;23;60;37;4;18;41;111;1
BIZKAIA;34;ERMUA;1;8;A;568;339;2;337;6;331;229;67;101;37;3;28;34;61;0
BIZKAIA;34;ERMUA;1;8;B;527;328;2;326;4;322;199;56;74;28;3;24;45;91;1
BIZKAIA;34;ERMUA;1;8;C;526;318;1;317;4;313;208;54;93;26;3;8;46;81;2
BIZKAIA;34;ERMUA;1;9;A;684;394;3;391;7;384;290;57;95;26;4;19;69;113;1
BIZKAIA;34;ERMUA;1;9;B;568;318;3;315;6;309;250;51;64;19;1;14;35;125;0
BIZKAIA;34;ERMUA;1;10;U;866;506;3;503;0;503;360;122;114;62;2;25;77;99;2
BIZKAIA;34;ERMUA;1;11;A;527;300;5;295;3;292;227;45;60;24;1;18;42;100;2
BIZKAIA;34;ERMUA;1;11;B;432;240;3;237;6;231;192;34;52;12;1;4;50;78;0
BIZKAIA;35;FRUIZ;1;1;U;267;168;1;167;2;165;99;121;7;25;0;12;0;0;0
BIZKAIA;36;GALDAKAO;1;1;U;829;561;2;559;8;551;268;225;78;74;1;54;46;71;2
BIZKAIA;36;GALDAKAO;1;2;U;812;561;7;554;6;548;251;229;67;89;1;52;44;66;0
BIZKAIA;36;GALDAKAO;1;3;A;560;330;2;328;0;328;230;111;33;63;1;37;28;55;0
BIZKAIA;36;GALDAKAO;1;3;B;568;316;0;316;3;313;252;103;30;55;1;36;33;54;1
BIZKAIA;36;GALDAKAO;1;4;A;705;415;3;412;6;406;290;152;52;62;3;23;38;75;1
BIZKAIA;36;GALDAKAO;1;4;B;676;393;0;393;1;392;283;152;30;49;1;33;69;58;0
BIZKAIA;36;GALDAKAO;1;5;A;583;310;1;309;0;309;273;111;24;57;0;34;35;48;0
BIZKAIA;36;GALDAKAO;1;5;B;414;239;1;238;1;237;175;84;12;39;0;28;24;50;0
BIZKAIA;36;GALDAKAO;1;6;A;826;471;2;469;6;463;355;135;35;83;2;45;47;115;1
BIZKAIA;36;GALDAKAO;1;6;B;776;433;1;432;2;430;343;101;35;91;2;43;55;103;0
BIZKAIA;36;GALDAKAO;1;7;U;616;343;4;339;4;335;273;122;65;34;1;23;24;66;0
BIZKAIA;36;GALDAKAO;1;8;U;1002;638;2;636;12;624;364;263;44;149;0;69;40;57;2
BIZKAIA;36;GALDAKAO;1;9;A;724;408;2;406;9;397;316;135;30;69;0;48;47;67;1
BIZKAIA;36;GALDAKAO;1;9;B;752;416;2;414;7;407;336;108;41;51;1;30;72;104;0
BIZKAIA;36;GALDAKAO;1;10;A;668;364;2;362;8;354;304;114;30;72;1;39;45;53;0
BIZKAIA;36;GALDAKAO;1;10;B;647;395;4;391;2;389;252;123;28;74;2;31;44;87;0
BIZKAIA;36;GALDAKAO;1;11;A;827;498;6;492;9;483;329;143;55;83;0;45;50;106;1
BIZKAIA;36;GALDAKAO;1;11;B;733;421;7;414;4;410;312;120;42;74;1;31;39;101;2
BIZKAIA;36;GALDAKAO;1;12;A;908;565;1;564;6;558;343;242;55;100;4;42;53;62;0
BIZKAIA;36;GALDAKAO;1;12;B;761;466;0;466;9;457;295;166;50;83;4;45;48;61;0
BIZKAIA;36;GALDAKAO;1;13;U;1008;637;3;634;13;621;371;259;49;125;1;64;70;53;0
BIZKAIA;36;GALDAKAO;1;14;A;880;579;2;577;9;568;301;236;57;116;1;78;41;39;0
BIZKAIA;36;GALDAKAO;1;14;B;815;503;0;503;8;495;312;186;66;84;0;53;52;54;0
BIZKAIA;36;GALDAKAO;1;15;U;760;402;1;401;6;395;358;115;38;46;2;32;72;90;0
BIZKAIA;36;GALDAKAO;2;1;A;794;397;2;395;1;394;397;122;38;56;0;23;36;118;1
BIZKAIA;36;GALDAKAO;2;1;B;806;394;0;394;6;388;412;109;48;48;0;28;56;98;1
BIZKAIA;36;GALDAKAO;3;1;U;604;370;2;368;3;365;234;198;24;66;1;41;16;19;0
BIZKAIA;36;GALDAKAO;4;1;U;516;317;1;316;8;308;199;114;28;70;0;16;38;42;0
BIZKAIA;36;GALDAKAO;4;2;A;634;409;2;407;8;399;225;161;21;80;2;55;34;46;0
BIZKAIA;36;GALDAKAO;4;2;B;551;362;2;360;1;359;189;142;21;70;0;40;26;59;1
BIZKAIA;36;GALDAKAO;4;3;A;651;426;4;422;11;411;225;185;28;79;0;57;17;45;0
BIZKAIA;36;GALDAKAO;4;3;B;554;345;0;345;4;341;209;159;19;78;1;33;21;28;2
BIZKAIA;36;GALDAKAO;4;3;C;220;126;1;125;2;123;94;60;13;29;1;5;5;10;0
BIZKAIA;37;GALDAMES;1;1;A;355;262;0;262;3;259;93;155;10;37;0;41;7;9;0
BIZKAIA;37;GALDAMES;1;1;B;347;255;3;252;0;252;92;131;15;28;0;27;15;36;0
BIZKAIA;38;GAMIZ-FIKA;1;1;U;793;549;2;547;5;542;244;353;5;117;0;52;9;5;1
BIZKAIA;39;GARAI;1;1;U;212;159;0;159;5;154;53;99;6;35;0;13;1;0;0
BIZKAIA;40;GATIKA;1;1;U;796;575;4;571;8;563;221;259;36;108;0;141;3;16;0
BIZKAIA;41;GAUTEGIZ ARTEAGA;1;1;U;632;492;6;486;8;478;140;301;17;91;0;56;6;7;0
BIZKAIA;42;GORDEXOLA;1;1;U;641;496;16;480;5;475;145;248;95;31;1;39;26;33;2
BIZKAIA;42;GORDEXOLA;1;2;U;639;501;8;493;5;488;138;307;70;37;2;28;22;21;1
BIZKAIA;43;GORLIZ;1;1;A;949;585;9;576;11;565;364;275;48;86;1;81;42;32;0
BIZKAIA;43;GORLIZ;1;1;B;885;536;8;528;9;519;349;251;51;81;0;77;34;25;0
BIZKAIA;43;GORLIZ;1;2;U;760;489;6;483;13;470;271;277;37;64;0;49;18;23;2
BIZKAIA;44;GETXO;1;1;U;794;527;2;525;8;517;267;197;115;57;2;61;38;46;1
BIZKAIA;44;GETXO;1;2;A;672;356;2;354;11;343;316;122;32;73;0;33;37;45;1
BIZKAIA;44;GETXO;1;2;B;620;335;3;332;8;324;285;113;43;64;0;20;40;44;0
BIZKAIA;44;GETXO;1;3;U;1136;757;3;754;9;745;379;367;105;114;1;88;25;45;0
BIZKAIA;44;GETXO;1;4;A;734;489;4;485;10;475;245;181;70;66;3;74;36;45;0
BIZKAIA;44;GETXO;1;4;B;717;448;1;447;11;436;269;134;53;68;1;68;56;56;0
BIZKAIA;44;GETXO;1;5;U;1132;704;3;701;21;680;428;256;139;69;4;61;65;86;0
BIZKAIA;44;GETXO;1;6;U;1148;701;2;699;13;686;447;241;69;135;6;96;57;82;0
BIZKAIA;44;GETXO;1;7;A;624;384;2;382;6;376;240;156;38;55;3;31;49;44;0
BIZKAIA;44;GETXO;1;7;B;642;367;3;364;7;357;275;103;50;58;6;27;61;52;0
BIZKAIA;44;GETXO;1;8;U;1099;731;2;729;18;711;368;270;138;79;7;84;65;67;1
BIZKAIA;44;GETXO;2;1;A;760;484;5;479;19;460;276;192;85;45;0;56;27;54;1
BIZKAIA;44;GETXO;2;1;B;763;476;2;474;14;460;287;172;96;56;3;50;42;41;0
BIZKAIA;44;GETXO;2;2;U;696;423;0;423;10;413;273;150;133;43;1;34;25;27;0
BIZKAIA;44;GETXO;2;3;A;638;431;1;430;8;422;207;198;75;53;1;48;23;24;0
BIZKAIA;44;GETXO;2;3;B;602;399;2;397;10;387;203;195;51;56;1;34;21;29;0
BIZKAIA;44;GETXO;2;4;U;735;533;7;526;8;518;202;194;136;99;2;49;28;10;0
BIZKAIA;44;GETXO;2;5;U;914;607;6;601;6;595;307;273;66;79;1;79;36;60;1
BIZKAIA;44;GETXO;2;6;A;628;392;2;390;4;386;236;174;36;72;0;34;34;35;1
BIZKAIA;44;GETXO;2;6;B;621;391;2;389;6;383;230;148;33;90;0;33;43;35;1
BIZKAIA;44;GETXO;2;7;A;682;396;1;395;2;393;286;163;46;76;1;28;44;35;0
BIZKAIA;44;GETXO;2;7;B;664;404;5;399;7;392;260;163;70;58;0;29;31;41;0
BIZKAIA;44;GETXO;2;8;U;1056;675;2;673;8;665;381;253;151;102;0;58;35;65;1
BIZKAIA;44;GETXO;2;9;A;864;604;4;600;13;587;260;147;378;10;1;30;5;16;0
BIZKAIA;44;GETXO;2;9;B;793;575;0;575;14;561;218;122;372;8;2;21;9;25;2
BIZKAIA;44;GETXO;2;10;U;1158;776;1;775;9;766;382;173;427;46;1;47;18;54;0
BIZKAIA;44;GETXO;2;11;U;694;424;0;424;7;417;270;156;47;65;0;46;41;61;1
BIZKAIA;44;GETXO;2;12;A;647;426;0;426;11;415;221;183;60;65;1;32;27;47;0
BIZKAIA;44;GETXO;2;12;B;629;398;1;397;12;385;231;152;60;58;1;30;40;42;2
BIZKAIA;44;GETXO;2;13;A;672;392;0;392;12;380;280;140;64;37;1;48;51;39;0
BIZKAIA;44;GETXO;2;13;B;725;429;0;429;5;424;296;137;77;52;0;40;50;67;1
BIZKAIA;44;GETXO;2;14;U;994;668;4;664;12;652;326;275;104;121;1;53;51;44;3
BIZKAIA;44;GETXO;2;15;A;595;345;0;345;5;340;250;107;100;33;0;36;23;41;0
BIZKAIA;44;GETXO;2;15;B;641;369;1;368;12;356;272;92;121;28;2;36;32;45;0
BIZKAIA;44;GETXO;2;16;U;884;587;0;587;17;570;297;272;117;55;4;68;23;31;0
BIZKAIA;44;GETXO;2;17;U;884;525;0;525;17;508;359;216;54;80;5;41;52;59;1
BIZKAIA;44;GETXO;2;18;U;787;477;2;475;7;468;310;194;62;76;1;52;47;36;0
BIZKAIA;44;GETXO;2;19;A;770;525;1;524;5;519;245;220;117;52;0;29;48;53;0
BIZKAIA;44;GETXO;2;19;B;695;462;0;462;11;451;233;185;93;50;2;37;28;56;0
BIZKAIA;44;GETXO;2;20;A;677;387;4;383;8;375;290;118;45;87;0;32;39;53;1
BIZKAIA;44;GETXO;2;20;B;640;341;1;340;11;329;299;117;47;50;2;22;27;62;2
BIZKAIA;44;GETXO;2;21;U;1145;778;2;776;26;750;367;300;198;79;0;58;45;70;0
BIZKAIA;44;GETXO;2;22;U;1187;789;4;785;16;769;398;316;130;96;1;117;37;72;0
BIZKAIA;44;GETXO;2;23;U;760;538;2;536;6;530;222;77;403;3;0;18;9;20;0
BIZKAIA;44;GETXO;2;24;U;869;580;10;570;20;550;289;234;90;52;0;68;46;60;0
BIZKAIA;44;GETXO;2;25;U;805;484;0;484;10;474;321;180;49;81;3;43;47;69;2
BIZKAIA;44;GETXO;2;26;U;879;627;1;626;12;614;252;187;249;53;2;42;39;42;0
BIZKAIA;44;GETXO;2;27;U;629;383;0;383;9;374;246;164;47;49;0;37;29;48;0
BIZKAIA;44;GETXO;2;28;U;645;410;1;409;8;401;235;183;61;61;0;42;24;30;0
BIZKAIA;44;GETXO;2;29;U;672;405;1;404;8;396;267;173;55;59;3;33;37;36;0
BIZKAIA;44;GETXO;2;30;U;1210;764;1;763;26;737;446;295;163;57;2;62;70;87;1
BIZKAIA;44;GETXO;3;1;U;768;544;0;544;11;533;224;112;351;9;0;21;10;30;0
BIZKAIA;44;GETXO;3;2;U;1058;729;4;725;16;709;329;223;348;24;1;40;33;39;1
BIZKAIA;44;GETXO;3;3;U;948;688;7;681;13;668;260;199;335;19;4;45;23;42;1
BIZKAIA;44;GETXO;3;4;A;757;484;0;484;8;476;273;176;188;16;0;28;21;46;1
BIZKAIA;44;GETXO;3;4;B;707;446;3;443;11;432;261;169;138;20;1;28;32;42;2
BIZKAIA;44;GETXO;3;5;U;560;391;0;391;18;373;169;127;156;16;0;23;17;34;0
BIZKAIA;44;GETXO;3;6;U;1107;732;0;732;17;715;375;294;239;49;0;35;35;63;0
BIZKAIA;44;GETXO;3;7;U;624;390;1;389;7;382;234;144;65;42;2;31;39;57;2
BIZKAIA;44;GETXO;3;8;U;1123;686;4;682;5;677;437;276;72;108;1;56;51;111;2
BIZKAIA;44;GETXO;3;9;U;1015;702;1;701;20;681;313;211;305;26;1;58;32;47;1
BIZKAIA;44;GETXO;3;10;U;1094;749;2;747;20;727;345;282;238;36;1;36;42;92;0
BIZKAIA;44;GETXO;3;11;U;811;575;6;569;15;554;236;233;155;33;1;53;35;44;0
BIZKAIA;44;GETXO;3;12;U;723;442;1;441;5;436;281;166;59;63;0;25;48;75;0
BIZKAIA;44;GETXO;3;13;A;733;524;1;523;7;516;209;150;261;20;1;30;22;32;0
BIZKAIA;44;GETXO;3;13;B;628;438;0;438;13;425;190;124;192;18;2;27;22;40;0
BIZKAIA;44;GETXO;3;14;U;1103;724;3;721;15;706;379;223;305;47;3;55;33;40;0
BIZKAIA;44;GETXO;3;15;U;780;477;1;476;14;462;303;166;136;29;3;37;34;57;0
BIZKAIA;44;GETXO;3;16;U;823;543;3;540;14;526;280;214;76;58;0;45;39;94;0
BIZKAIA;44;GETXO;3;17;A;632;449;0;449;16;433;183;161;91;46;0;37;38;58;2
BIZKAIA;44;GETXO;3;17;B;636;427;3;424;18;406;209;136;88;43;1;33;47;57;1
BIZKAIA;44;GETXO;3;18;U;981;547;2;545;5;540;434;208;99;65;3;40;55;69;1
BIZKAIA;44;GETXO;3;19;U;895;502;4;498;13;485;393;174;83;72;1;23;48;83;1
BIZKAIA;44;GETXO;3;20;U;792;499;3;496;10;486;293;221;55;84;1;34;29;62;0
BIZKAIA;44;GETXO;3;21;U;836;502;0;502;7;495;334;176;53;65;1;33;69;98;0
BIZKAIA;44;GETXO;3;22;U;1078;750;0;750;15;735;328;280;274;22;0;47;48;61;3
BIZKAIA;44;GETXO;3;23;U;808;569;3;566;10;556;239;213;208;38;1;31;20;45;0
BIZKAIA;44;GETXO;3;24;U;714;451;0;451;12;439;263;189;90;44;1;37;29;49;0
BIZKAIA;44;GETXO;3;25;U;1005;701;2;699;10;689;304;130;473;6;1;25;19;34;1
BIZKAIA;44;GETXO;3;26;U;681;432;1;431;16;415;249;181;86;37;2;29;23;57;0
BIZKAIA;45;G?E?ES;1;1;U;900;719;2;717;8;709;181;424;45;36;1;122;26;55;0
BIZKAIA;45;G?E?ES;2;1;A;471;333;5;328;3;325;138;147;20;62;1;36;15;43;1
BIZKAIA;45;G?E?ES;2;1;B;632;450;7;443;5;438;182;184;18;103;0;65;26;41;1
BIZKAIA;45;G?E?ES;2;2;U;905;741;7;734;11;723;164;392;55;79;0;64;29;103;1
BIZKAIA;45;G?E?ES;2;3;A;586;470;3;467;10;457;116;237;26;48;1;37;29;79;0
BIZKAIA;45;G?E?ES;2;3;B;624;487;2;485;6;479;137;227;20;70;1;56;27;77;1
BIZKAIA;45;G?E?ES;2;4;A;251;201;1;200;5;195;50;94;8;55;0;31;3;4;0
BIZKAIA;45;G?E?ES;2;4;B;497;409;3;406;2;404;88;136;20;72;0;128;11;36;1
BIZKAIA;46;GERNIKA-LUMO;1;1;A;992;721;5;716;2;714;271;349;45;152;1;102;14;51;0
BIZKAIA;46;GERNIKA-LUMO;1;1;B;753;511;7;504;2;502;242;225;35;115;2;53;16;56;0
BIZKAIA;46;GERNIKA-LUMO;1;2;A;728;522;1;521;2;519;206;244;25;128;0;87;12;23;0
BIZKAIA;46;GERNIKA-LUMO;1;2;B;516;373;1;372;4;368;143;180;27;67;0;55;12;27;0
BIZKAIA;46;GERNIKA-LUMO;1;3;U;1254;925;4;921;12;909;329;417;82;192;0;143;22;52;1
BIZKAIA;46;GERNIKA-LUMO;1;4;A;893;582;11;571;8;563;311;180;56;151;1;68;31;75;1
BIZKAIA;46;GERNIKA-LUMO;1;4;B;779;495;3;492;12;480;284;137;42;116;0;51;36;97;1
BIZKAIA;46;GERNIKA-LUMO;1;5;A;702;516;4;512;4;508;186;225;37;131;0;85;11;19;0
BIZKAIA;46;GERNIKA-LUMO;1;5;B;555;389;0;389;5;384;166;186;26;82;1;61;10;18;0
BIZKAIA;46;GERNIKA-LUMO;1;6;U;1144;832;9;823;11;812;312;383;81;146;1;158;25;17;1
BIZKAIA;46;GERNIKA-LUMO;1;7;A;801;526;5;521;1;520;275;218;21;154;0;58;20;49;0
BIZKAIA;46;GERNIKA-LUMO;1;7;B;661;429;5;424;3;421;232;176;28;92;1;55;22;47;0
BIZKAIA;46;GERNIKA-LUMO;2;1;U;940;595;3;592;7;585;345;260;45;150;0;67;15;47;1
BIZKAIA;46;GERNIKA-LUMO;2;2;U;1051;743;2;741;13;728;308;347;42;152;0;84;45;57;1
BIZKAIA;46;GERNIKA-LUMO;2;3;U;1036;661;6;655;16;639;375;231;61;141;1;49;40;115;1
BIZKAIA;47;GIZABURUAGA;1;1;U;117;87;0;87;3;84;30;40;1;36;0;7;0;0;0
BIZKAIA;48;IBARRANGELU;1;1;U;479;364;3;361;3;358;115;238;6;73;0;36;0;5;0
BIZKAIA;49;ISPASTER;1;1;U;521;393;1;392;0;392;128;268;19;61;0;35;5;4;0
BIZKAIA;50;IZURTZA;1;1;U;228;163;2;161;0;161;65;96;8;37;0;14;4;2;0
BIZKAIA;51;LANESTOSA;1;1;U;257;189;2;187;3;184;68;112;21;16;1;0;4;30;0
BIZKAIA;52;LARRABETZU;1;1;A;678;521;3;518;2;516;157;283;11;173;0;22;9;18;0
BIZKAIA;52;LARRABETZU;1;1;B;577;452;2;450;6;444;125;233;33;137;0;21;4;16;0
BIZKAIA;53;LAUKIZ;1;1;U;795;565;2;563;9;554;230;319;82;47;0;90;8;8;0
BIZKAIA;54;LEIOA;1;1;U;925;530;2;528;9;519;395;235;34;105;0;27;50;66;2
BIZKAIA;54;LEIOA;1;2;U;1212;747;7;740;17;723;465;295;79;110;2;27;85;125;0
BIZKAIA;54;LEIOA;1;3;A;714;388;2;386;4;382;326;133;37;63;0;18;67;64;0
BIZKAIA;54;LEIOA;1;3;B;650;356;1;355;7;348;294;111;46;37;0;17;55;82;0
BIZKAIA;54;LEIOA;1;4;U;645;354;1;353;7;346;291;103;31;51;1;16;81;63;0
BIZKAIA;54;LEIOA;1;5;U;884;538;1;537;8;529;346;255;48;51;1;31;58;85;0
BIZKAIA;54;LEIOA;1;6;U;912;607;2;605;25;580;305;199;105;36;1;52;98;89;0
BIZKAIA;54;LEIOA;1;7;U;1121;612;5;607;12;595;509;210;60;66;2;31;80;146;0
BIZKAIA;54;LEIOA;2;1;A;669;380;2;378;3;375;289;115;36;71;3;32;44;74;0
BIZKAIA;54;LEIOA;2;1;B;675;372;2;370;3;367;303;92;41;81;3;21;63;62;4
BIZKAIA;54;LEIOA;2;2;A;667;414;1;413;12;401;253;138;66;33;1;26;46;90;1
BIZKAIA;54;LEIOA;2;2;B;710;420;2;418;12;406;290;142;71;40;1;27;44;80;1
BIZKAIA;54;LEIOA;2;3;A;646;380;2;378;16;362;266;129;62;38;0;13;50;70;0
BIZKAIA;54;LEIOA;2;3;B;742;388;0;388;3;385;354;134;43;45;0;25;56;81;1
BIZKAIA;54;LEIOA;3;1;U;1112;681;5;676;7;669;431;342;49;81;1;31;65;98;2
BIZKAIA;54;LEIOA;3;2;U;1083;672;3;669;16;653;411;258;80;62;1;38;120;93;1
BIZKAIA;54;LEIOA;3;3;U;938;588;4;584;12;572;350;268;48;75;0;28;55;97;1
BIZKAIA;54;LEIOA;3;4;U;990;658;1;657;20;637;332;218;125;66;3;44;79;98;4
BIZKAIA;54;LEIOA;3;5;U;899;485;3;482;10;472;414;165;41;45;0;23;83;114;1
BIZKAIA;54;LEIOA;3;6;U;1074;651;1;650;13;637;423;242;75;54;0;56;95;115;0
BIZKAIA;54;LEIOA;3;7;A;653;412;4;408;7;401;241;193;32;63;1;19;49;42;2
BIZKAIA;54;LEIOA;3;7;B;648;387;3;384;8;376;261;159;31;56;2;20;58;49;1
BIZKAIA;54;LEIOA;3;8;U;1219;810;2;808;27;781;409;320;155;79;0;75;76;76;0
BIZKAIA;55;LEMOA;1;1;A;558;487;3;484;5;479;71;272;30;73;1;76;17;10;0
BIZKAIA;55;LEMOA;1;1;B;417;341;5;336;1;335;76;155;27;37;0;92;9;15;0
BIZKAIA;55;LEMOA;1;2;A;701;583;4;579;2;577;118;347;22;107;0;70;9;21;1
BIZKAIA;55;LEMOA;1;2;B;454;375;9;366;2;364;79;202;17;58;2;47;12;26;0
BIZKAIA;56;LEMOIZ;1;1;U;684;463;6;457;11;446;221;276;19;108;0;26;6;11;0
BIZKAIA;57;LEKEITIO;1;1;U;595;428;2;426;1;425;167;144;7;158;1;107;6;2;0
BIZKAIA;57;LEKEITIO;1;2;U;1139;886;0;886;8;878;253;377;11;244;1;234;8;3;0
BIZKAIA;57;LEKEITIO;2;1;U;730;527;1;526;11;515;203;225;23;129;0;116;10;12;0
BIZKAIA;57;LEKEITIO;2;2;U;977;681;1;680;13;667;296;259;18;249;2;122;10;7;0
BIZKAIA;57;LEKEITIO;2;3;U;1056;749;0;749;7;742;307;321;14;204;0;157;21;25;0
BIZKAIA;57;LEKEITIO;2;4;U;937;670;7;663;6;657;267;227;5;296;0;107;9;13;0
BIZKAIA;57;LEKEITIO;2;5;U;828;519;3;516;7;509;309;223;19;128;0;102;19;17;1
BIZKAIA;58;MALLABIA;1;1;U;915;637;2;635;3;632;278;235;19;273;0;26;17;62;0
BIZKAIA;59;MA?ARIA;1;1;U;412;306;3;303;5;298;106;203;13;64;0;13;2;3;0
BIZKAIA;60;MARKINA-XEMEIN;1;1;A;999;626;4;622;4;618;373;366;34;131;1;55;12;19;0
BIZKAIA;60;MARKINA-XEMEIN;1;1;B;622;376;1;375;4;371;246;175;27;106;1;24;15;21;2
BIZKAIA;60;MARKINA-XEMEIN;1;2;A;815;520;3;517;8;509;295;237;35;145;0;64;13;14;1
BIZKAIA;60;MARKINA-XEMEIN;1;2;B;563;342;7;335;1;334;221;148;32;92;0;42;9;11;0
BIZKAIA;60;MARKINA-XEMEIN;1;3;A;555;299;1;298;2;296;256;148;15;112;0;16;2;3;0
BIZKAIA;60;MARKINA-XEMEIN;1;3;B;365;275;0;275;2;273;90;158;6;88;0;15;0;6;0
BIZKAIA;61;MARURI-JATABE;1;1;U;444;284;1;283;2;281;160;165;33;25;1;44;8;5;0
BIZKAIA;62;MENDATA;1;1;U;293;240;0;240;1;239;53;149;6;41;0;38;1;4;0
BIZKAIA;63;MENDEXA;1;1;U;305;235;2;233;0;233;70;121;9;82;0;15;2;3;1
BIZKAIA;64;ME?AKA;1;1;U;372;294;2;292;1;291;78;137;13;43;0;97;0;1;0
BIZKAIA;65;UGAO-MIRABALLES;1;1;U;849;567;4;563;3;560;282;245;53;128;2;40;29;63;0
BIZKAIA;65;UGAO-MIRABALLES;1;2;U;831;521;5;516;4;512;310;239;24;106;0;29;26;85;3
BIZKAIA;65;UGAO-MIRABALLES;1;3;U;906;578;4;574;6;568;328;191;65;141;2;51;28;90;0
BIZKAIA;65;UGAO-MIRABALLES;1;4;U;762;502;2;500;4;496;260;203;35;126;0;40;23;69;0
BIZKAIA;66;MORGA;1;1;U;287;210;0;210;0;210;77;161;9;22;0;18;0;0;0
BIZKAIA;67;MUXIKA;1;1;A;966;766;4;762;2;760;200;368;21;269;0;92;8;2;0
BIZKAIA;67;MUXIKA;1;1;B;260;208;0;208;0;208;52;100;3;80;0;25;0;0;0
BIZKAIA;68;MUNDAKA;1;1;A;829;668;6;662;3;659;161;363;17;142;0;118;9;10;0
BIZKAIA;68;MUNDAKA;1;1;B;607;505;8;497;5;492;102;278;18;108;0;71;10;7;0
BIZKAIA;69;MUNGIA;1;1;U;1156;760;6;754;5;749;396;402;50;120;0;86;48;43;0
BIZKAIA;69;MUNGIA;1;2;A;764;482;3;479;8;471;282;251;36;76;1;43;26;36;2
BIZKAIA;69;MUNGIA;1;2;B;645;375;4;371;2;369;270;204;26;53;3;35;13;34;1
BIZKAIA;69;MUNGIA;1;3;A;654;372;0;372;10;362;282;190;19;48;1;32;10;62;0
BIZKAIA;69;MUNGIA;1;3;B;692;404;1;403;10;393;288;183;26;53;1;40;23;65;2
BIZKAIA;69;MUNGIA;1;4;U;1061;616;5;611;4;607;445;381;31;76;0;75;23;21;0
BIZKAIA;69;MUNGIA;1;5;A;771;518;2;516;4;512;253;303;23;83;0;56;15;32;0
BIZKAIA;69;MUNGIA;1;5;B;659;418;4;414;4;410;241;236;29;58;0;36;23;28;0
BIZKAIA;69;MUNGIA;1;6;U;1164;730;4;726;14;712;434;430;42;103;1;59;20;57;0
BIZKAIA;69;MUNGIA;1;7;U;576;315;4;311;0;311;261;153;22;44;0;38;21;33;0
BIZKAIA;69;MUNGIA;2;1;A;997;623;3;620;5;615;374;377;107;57;0;47;8;19;0
BIZKAIA;69;MUNGIA;2;1;B;751;467;1;466;5;461;284;247;108;45;1;29;11;20;0
BIZKAIA;70;AULESTI;1;1;U;584;379;3;376;4;372;205;184;2;153;0;25;3;5;0
BIZKAIA;71;MUSKIZ;1;1;A;808;566;2;564;6;558;242;245;31;69;2;51;66;94;0
BIZKAIA;71;MUSKIZ;1;1;B;782;554;7;547;11;536;228;238;38;60;0;48;45;106;1
BIZKAIA;71;MUSKIZ;1;2;A;800;572;5;567;12;555;228;260;32;47;0;42;57;117;0
BIZKAIA;71;MUSKIZ;1;2;B;750;541;8;533;4;529;209;237;34;49;1;52;54;101;1
BIZKAIA;71;MUSKIZ;1;3;A;780;537;2;535;7;528;243;228;28;64;1;38;31;137;1
BIZKAIA;71;MUSKIZ;1;3;B;769;508;7;501;14;487;261;222;24;43;1;39;49;109;0
BIZKAIA;71;MUSKIZ;2;1;A;298;211;0;211;2;209;87;82;10;27;0;3;15;72;0
BIZKAIA;71;MUSKIZ;2;1;B;249;192;1;191;3;188;57;89;14;27;0;17;11;30;0
BIZKAIA;72;OTXANDIO;1;1;U;920;667;5;662;2;660;253;329;44;198;0;52;17;20;0
BIZKAIA;73;ONDARROA;1;1;A;872;580;3;577;1;576;292;233;28;229;0;64;10;12;0
BIZKAIA;73;ONDARROA;1;1;B;586;378;2;376;4;372;208;149;31;120;0;45;10;17;0
BIZKAIA;73;ONDARROA;1;2;U;1086;764;7;757;10;747;322;294;81;261;0;88;8;13;2
BIZKAIA;73;ONDARROA;1;3;U;1147;845;8;837;8;829;302;390;90;289;1;41;10;8;0
BIZKAIA;73;ONDARROA;2;1;U;658;474;5;469;2;467;184;193;28;162;2;67;5;10;0
BIZKAIA;73;ONDARROA;2;2;U;1375;897;10;887;6;881;478;355;48;336;2;97;14;28;1
BIZKAIA;73;ONDARROA;2;3;A;1134;707;7;700;5;695;427;238;37;335;1;48;10;26;0
BIZKAIA;73;ONDARROA;2;3;B;726;432;4;428;5;423;294;138;20;198;2;36;8;21;0
BIZKAIA;73;ONDARROA;3;1;U;983;588;7;581;12;569;395;238;25;220;2;56;11;17;0
BIZKAIA;74;URDU?A-ORDU?A;1;1;U;876;590;16;574;5;569;286;206;91;110;7;46;40;69;0
BIZKAIA;74;URDU?A-ORDU?A;1;2;A;503;341;4;337;1;336;162;157;52;64;2;24;17;20;0
BIZKAIA;74;URDU?A-ORDU?A;1;2;B;635;420;11;409;2;407;215;199;51;57;1;27;34;38;0
BIZKAIA;74;URDU?A-ORDU?A;2;1;A;542;374;6;368;9;359;168;169;46;60;1;25;23;35;0
BIZKAIA;74;URDU?A-ORDU?A;2;1;B;762;532;10;522;6;516;230;248;60;98;4;37;24;44;1
BIZKAIA;75;OROZKO;1;1;A;574;365;1;364;8;356;209;216;48;61;1;17;6;7;0
BIZKAIA;75;OROZKO;1;1;B;682;455;8;447;2;445;227;285;60;68;0;18;0;14;0
BIZKAIA;75;OROZKO;1;1;C;386;227;4;223;3;220;159;112;18;48;0;32;5;5;0
BIZKAIA;76;SUKARRIETA;1;1;U;260;201;1;200;1;199;59;109;15;31;0;36;3;5;0
BIZKAIA;77;PLENTZIA;1;1;U;812;562;5;557;11;546;250;265;41;104;0;72;24;40;0
BIZKAIA;77;PLENTZIA;1;2;A;855;589;8;581;11;570;266;316;57;90;2;59;18;28;0
BIZKAIA;77;PLENTZIA;1;2;B;741;504;2;502;8;494;237;293;34;57;0;68;16;26;0
BIZKAIA;78;PORTUGALETE;1;1;U;869;545;0;545;11;534;324;162;88;105;2;40;57;79;1
BIZKAIA;78;PORTUGALETE;1;2;U;1091;759;0;759;13;746;332;274;242;51;0;57;32;90;0
BIZKAIA;78;PORTUGALETE;1;3;A;728;497;1;496;9;487;231;219;110;38;0;25;28;67;0
BIZKAIA;78;PORTUGALETE;1;3;B;701;464;6;458;11;447;237;178;93;43;0;38;37;58;0
BIZKAIA;78;PORTUGALETE;1;4;U;1106;617;9;608;12;596;489;182;99;51;5;26;93;140;0
BIZKAIA;78;PORTUGALETE;1;5;U;805;496;6;490;8;482;309;112;82;48;0;33;70;136;1
BIZKAIA;78;PORTUGALETE;1;6;A;781;497;2;495;12;483;284;162;88;41;2;36;48;104;2
BIZKAIA;78;PORTUGALETE;1;6;B;850;573;2;571;6;565;277;207;130;35;2;33;54;104;0
BIZKAIA;78;PORTUGALETE;1;7;U;835;485;3;482;5;477;350;145;89;52;1;16;41;133;0
BIZKAIA;78;PORTUGALETE;1;8;A;626;356;8;348;6;342;270;86;36;20;1;7;63;128;1
BIZKAIA;78;PORTUGALETE;1;8;B;644;339;1;338;5;333;305;73;46;27;1;14;56;115;1
BIZKAIA;78;PORTUGALETE;1;9;A;763;470;1;469;8;461;293;126;111;36;2;25;66;95;0
BIZKAIA;78;PORTUGALETE;1;9;B;870;517;0;517;7;510;353;180;120;30;3;18;60;99;0
BIZKAIA;78;PORTUGALETE;2;1;A;662;395;5;390;7;383;267;102;58;52;1;20;51;97;2
BIZKAIA;78;PORTUGALETE;2;1;B;671;369;3;366;4;362;302;88;53;33;2;26;57;102;1
BIZKAIA;78;PORTUGALETE;2;2;U;996;625;6;619;6;613;371;137;97;47;3;29;122;177;1
BIZKAIA;78;PORTUGALETE;2;3;U;1069;671;3;668;14;654;398;158;104;56;0;22;125;189;0
BIZKAIA;78;PORTUGALETE;2;4;U;931;595;3;592;11;581;336;153;51;78;2;42;107;148;0
BIZKAIA;78;PORTUGALETE;2;5;U;952;580;6;574;5;569;372;131;84;50;2;17;117;167;1
BIZKAIA;78;PORTUGALETE;2;6;A;640;382;2;380;9;371;258;82;36;36;2;9;83;123;0
BIZKAIA;78;PORTUGALETE;2;6;B;722;394;3;391;10;381;328;73;36;54;4;14;84;115;1
BIZKAIA;78;PORTUGALETE;2;7;U;747;445;5;440;5;435;302;98;46;53;0;14;88;136;0
BIZKAIA;78;PORTUGALETE;2;8;A;704;417;3;414;13;401;287;85;71;38;0;14;74;119;0
BIZKAIA;78;PORTUGALETE;2;8;B;792;447;9;438;7;431;345;98;64;30;0;13;76;150;0
BIZKAIA;78;PORTUGALETE;2;9;U;938;577;9;568;12;556;361;88;94;40;2;18;116;195;3
BIZKAIA;78;PORTUGALETE;2;10;U;1110;679;0;679;14;665;431;144;75;64;0;28;187;166;1
BIZKAIA;78;PORTUGALETE;3;1;U;892;496;3;493;9;484;396;145;86;75;1;27;59;91;0
BIZKAIA;78;PORTUGALETE;3;2;U;846;509;4;505;8;497;337;155;82;55;1;39;52;113;0
BIZKAIA;78;PORTUGALETE;3;3;A;764;455;1;454;11;443;309;122;84;38;0;28;57;113;1
BIZKAIA;78;PORTUGALETE;3;3;B;758;436;5;431;12;419;322;109;69;34;0;25;63;115;4
BIZKAIA;78;PORTUGALETE;3;4;A;571;352;5;347;5;342;219;110;19;36;0;19;39;119;0
BIZKAIA;78;PORTUGALETE;3;4;B;533;338;3;335;10;325;195;107;26;28;0;14;44;106;0
BIZKAIA;78;PORTUGALETE;3;5;A;619;341;2;339;8;331;278;103;40;43;0;18;51;74;2
BIZKAIA;78;PORTUGALETE;3;5;B;618;335;0;335;7;328;283;75;56;28;0;16;55;98;0
BIZKAIA;78;PORTUGALETE;3;6;A;563;322;3;319;5;314;241;63;38;66;0;20;47;78;2
BIZKAIA;78;PORTUGALETE;3;6;B;554;330;1;329;1;328;224;86;46;42;0;26;48;80;0
BIZKAIA;78;PORTUGALETE;3;7;A;675;393;3;390;8;382;282;96;48;36;0;11;67;122;2
BIZKAIA;78;PORTUGALETE;3;7;B;759;434;1;433;7;426;325;82;64;27;3;9;80;160;1
BIZKAIA;78;PORTUGALETE;3;8;A;703;362;1;361;2;359;341;74;53;23;0;17;70;120;2
BIZKAIA;78;PORTUGALETE;3;8;B;805;439;6;433;7;426;366;87;59;30;6;15;82;147;0
BIZKAIA;78;PORTUGALETE;3;9;A;702;406;3;403;8;395;296;102;74;34;1;22;66;94;2
BIZKAIA;78;PORTUGALETE;3;9;B;728;440;2;438;6;432;288;140;79;39;1;32;43;97;1
BIZKAIA;78;PORTUGALETE;3;10;U;934;469;2;467;3;464;465;91;56;46;4;18;100;147;2
BIZKAIA;78;PORTUGALETE;3;11;U;1110;671;8;663;12;651;439;198;112;72;2;33;84;148;2
BIZKAIA;78;PORTUGALETE;3;12;A;793;495;2;493;8;485;298;161;85;41;2;21;68;107;0
BIZKAIA;78;PORTUGALETE;3;12;B;896;567;2;565;13;552;329;178;71;50;1;23;101;128;0
BIZKAIA;78;PORTUGALETE;4;1;U;1105;629;5;624;14;610;476;131;109;49;0;30;98;192;1
BIZKAIA;78;PORTUGALETE;4;2;U;1012;617;2;615;12;603;395;110;44;41;5;37;135;230;1
BIZKAIA;78;PORTUGALETE;4;3;U;839;454;2;452;4;448;385;63;64;27;1;14;119;159;1
BIZKAIA;78;PORTUGALETE;4;4;U;1179;665;2;663;12;651;514;104;110;42;3;25;135;230;2
BIZKAIA;78;PORTUGALETE;4;5;U;573;327;1;326;3;323;246;65;65;27;0;19;43;104;0
BIZKAIA;78;PORTUGALETE;4;6;A;634;341;1;340;7;333;293;64;36;27;0;13;78;114;1
BIZKAIA;78;PORTUGALETE;4;6;B;721;357;0;357;7;350;364;64;47;23;0;14;69;133;0
BIZKAIA;78;PORTUGALETE;4;7;A;639;345;0;345;12;333;294;59;38;29;1;5;67;134;0
BIZKAIA;78;PORTUGALETE;4;7;B;669;376;1;375;14;361;293;75;44;21;0;12;59;150;0
BIZKAIA;78;PORTUGALETE;5;1;A;570;335;1;334;5;329;235;84;31;54;2;9;58;91;0
BIZKAIA;78;PORTUGALETE;5;1;B;637;302;4;298;6;292;335;66;43;40;1;10;44;88;0
BIZKAIA;78;PORTUGALETE;5;2;A;642;372;2;370;12;358;270;84;40;40;2;22;79;91;0
BIZKAIA;78;PORTUGALETE;5;2;B;631;362;5;357;6;351;269;61;50;24;3;15;88;109;1
BIZKAIA;79;ERRIGOITI;1;1;U;379;309;0;309;2;307;70;153;7;78;0;66;2;1;0
BIZKAIA;80;VALLE DE TR?PAGA-TRAPAGARAN;1;1;U;1263;755;3;752;13;739;508;242;64;91;3;37;90;212;0
BIZKAIA;80;VALLE DE TR?PAGA-TRAPAGARAN;1;2;A;534;342;3;339;7;332;192;98;29;46;1;14;35;109;0
BIZKAIA;80;VALLE DE TR?PAGA-TRAPAGARAN;1;2;B;595;379;5;374;4;370;216;132;21;54;1;22;51;89;0
BIZKAIA;80;VALLE DE TR?PAGA-TRAPAGARAN;1;3;U;755;419;3;416;7;409;336;117;35;54;0;15;65;122;1
BIZKAIA;80;VALLE DE TR?PAGA-TRAPAGARAN;1;4;U;1035;655;4;651;18;633;380;232;84;68;0;26;88;135;0
BIZKAIA;80;VALLE DE TR?PAGA-TRAPAGARAN;1;5;U;648;357;9;348;0;348;291;87;23;72;1;17;67;81;0
BIZKAIA;80;VALLE DE TR?PAGA-TRAPAGARAN;1;6;A;376;248;0;248;5;243;128;125;17;28;0;12;27;34;0
BIZKAIA;80;VALLE DE TR?PAGA-TRAPAGARAN;1;6;B;372;190;0;190;1;189;182;58;18;33;0;11;30;39;0
BIZKAIA;80;VALLE DE TR?PAGA-TRAPAGARAN;1;7;U;584;325;5;320;3;317;259;98;27;34;2;3;58;95;0
BIZKAIA;80;VALLE DE TR?PAGA-TRAPAGARAN;1;8;U;1031;569;6;563;17;546;462;147;42;85;4;13;90;165;0
BIZKAIA;80;VALLE DE TR?PAGA-TRAPAGARAN;1;9;A;747;412;4;408;7;401;335;116;32;51;1;16;75;110;0
BIZKAIA;80;VALLE DE TR?PAGA-TRAPAGARAN;1;9;B;841;488;4;484;8;476;353;117;40;70;1;22;97;129;0
BIZKAIA;80;VALLE DE TR?PAGA-TRAPAGARAN;1;10;U;1204;736;2;734;15;719;468;229;52;86;2;51;88;210;1
BIZKAIA;80;VALLE DE TR?PAGA-TRAPAGARAN;2;1;A;343;253;3;250;0;250;90;69;14;75;0;2;6;84;0
BIZKAIA;80;VALLE DE TR?PAGA-TRAPAGARAN;2;1;B;506;359;5;354;2;352;147;144;7;31;0;2;18;150;0
BIZKAIA;81;LEZAMA;1;1;A;882;666;5;661;6;655;216;447;27;109;0;42;17;13;0
BIZKAIA;81;LEZAMA;1;1;B;752;534;6;528;1;527;218;347;25;81;1;30;23;20;0
BIZKAIA;82;SANTURTZI;1;1;U;846;577;2;575;7;568;269;228;133;62;1;32;62;50;0
BIZKAIA;82;SANTURTZI;1;2;A;646;408;0;408;7;401;238;106;69;44;2;24;59;97;0
BIZKAIA;82;SANTURTZI;1;2;B;670;413;2;411;7;404;257;108;53;48;2;28;59;103;3
BIZKAIA;82;SANTURTZI;1;3;A;597;335;3;332;4;328;262;92;45;42;2;21;48;78;0
BIZKAIA;82;SANTURTZI;1;3;B;614;343;2;341;6;335;271;79;41;44;1;22;59;88;1
BIZKAIA;82;SANTURTZI;1;4;A;732;425;5;420;8;412;307;129;48;56;1;23;66;89;0
BIZKAIA;82;SANTURTZI;1;4;B;716;430;1;429;9;420;286;111;42;58;2;27;74;106;0
BIZKAIA;82;SANTURTZI;1;5;A;706;449;0;449;7;442;257;148;78;61;0;28;49;78;0
BIZKAIA;82;SANTURTZI;1;5;B;790;474;0;474;8;466;316;149;99;48;0;25;70;75;0
BIZKAIA;82;SANTURTZI;1;6;A;591;354;2;352;8;344;237;103;60;41;3;37;45;55;0
BIZKAIA;82;SANTURTZI;1;6;B;641;400;2;398;8;390;241;132;56;49;1;50;34;67;1
BIZKAIA;82;SANTURTZI;1;7;A;671;372;2;370;4;366;299;96;33;51;2;21;62;98;3
BIZKAIA;82;SANTURTZI;1;7;B;738;400;6;394;5;389;338;92;54;68;0;21;56;98;0
BIZKAIA;82;SANTURTZI;1;8;U;699;413;0;413;3;410;286;100;56;85;1;8;60;99;1
BIZKAIA;82;SANTURTZI;1;9;A;727;410;2;408;10;398;317;97;53;57;3;19;63;105;1
BIZKAIA;82;SANTURTZI;1;9;B;657;362;1;361;1;360;295;83;49;58;1;8;68;93;0
BIZKAIA;82;SANTURTZI;1;10;A;631;341;2;339;7;332;290;69;39;43;1;14;46;120;0
BIZKAIA;82;SANTURTZI;1;10;B;699;351;5;346;2;344;348;80;37;42;0;15;68;101;1
BIZKAIA;82;SANTURTZI;1;11;A;661;315;3;312;3;309;346;76;28;34;0;12;38;121;0
BIZKAIA;82;SANTURTZI;1;11;B;639;323;2;321;6;315;316;51;46;29;1;11;50;127;0
BIZKAIA;82;SANTURTZI;1;12;U;867;437;1;436;8;428;430;112;21;101;0;10;63;121;0
BIZKAIA;82;SANTURTZI;1;13;U;863;528;1;527;8;519;335;142;29;122;1;24;94;106;1
BIZKAIA;82;SANTURTZI;1;14;A;786;453;1;452;2;450;333;96;45;104;2;25;91;86;1
BIZKAIA;82;SANTURTZI;1;14;B;849;480;4;476;7;469;369;109;53;82;1;17;98;109;0
BIZKAIA;82;SANTURTZI;1;15;U;490;314;5;309;4;305;176;103;46;48;0;38;28;42;0
BIZKAIA;82;SANTURTZI;1;16;U;1240;763;5;758;10;748;477;187;64;213;0;28;109;147;0
BIZKAIA;82;SANTURTZI;1;17;U;816;513;1;512;6;506;303;166;74;47;0;19;94;106;0
BIZKAIA;82;SANTURTZI;2;1;A;601;355;5;350;1;349;246;91;29;45;0;19;58;106;1
BIZKAIA;82;SANTURTZI;2;1;B;652;369;3;366;6;360;283;77;54;46;0;18;55;110;0
BIZKAIA;82;SANTURTZI;2;2;U;599;375;4;371;7;364;224;117;46;53;2;8;60;77;1
BIZKAIA;82;SANTURTZI;2;3;A;720;434;1;433;5;428;286;115;53;65;0;28;60;106;1
BIZKAIA;82;SANTURTZI;2;3;B;700;394;4;390;3;387;306;118;43;54;0;14;55;101;2
BIZKAIA;82;SANTURTZI;2;4;U;897;467;3;464;3;461;430;87;49;45;4;16;82;176;2
BIZKAIA;82;SANTURTZI;2;5;U;1146;711;4;707;6;701;435;292;120;84;4;39;71;90;1
BIZKAIA;82;SANTURTZI;2;6;U;543;342;0;342;4;338;201;118;50;63;1;27;25;54;0
BIZKAIA;82;SANTURTZI;2;7;U;1060;634;5;629;8;621;426;237;102;81;1;34;58;108;0
BIZKAIA;82;SANTURTZI;2;8;A;690;459;2;457;11;446;231;186;84;50;1;18;39;68;0
BIZKAIA;82;SANTURTZI;2;8;B;727;446;6;440;4;436;281;146;110;42;0;18;41;78;1
BIZKAIA;82;SANTURTZI;3;1;U;1274;764;6;758;8;750;510;228;114;65;0;46;130;167;0
BIZKAIA;82;SANTURTZI;3;2;U;974;583;0;583;9;574;391;193;70;83;2;13;86;125;2
BIZKAIA;82;SANTURTZI;3;3;U;816;434;2;432;5;427;382;90;67;43;3;7;96;121;0
BIZKAIA;82;SANTURTZI;3;4;A;565;300;2;298;1;297;265;51;44;21;1;9;63;105;3
BIZKAIA;82;SANTURTZI;3;4;B;599;310;0;310;6;304;289;66;48;41;2;15;56;75;1
BIZKAIA;82;SANTURTZI;3;5;A;604;349;2;347;4;343;255;72;42;40;1;4;48;134;2
BIZKAIA;82;SANTURTZI;3;5;B;721;421;5;416;9;407;300;81;47;45;0;18;60;151;5
BIZKAIA;82;SANTURTZI;3;6;U;947;530;2;528;8;520;417;116;49;31;6;22;118;177;1
BIZKAIA;82;SANTURTZI;3;7;U;883;527;2;525;7;518;356;100;72;41;0;20;109;172;4
BIZKAIA;82;SANTURTZI;4;1;U;920;516;1;515;7;508;404;111;53;49;1;22;77;193;2
BIZKAIA;82;SANTURTZI;4;2;U;873;454;7;447;5;442;419;102;55;51;3;22;87;122;0
BIZKAIA;82;SANTURTZI;4;3;U;994;513;7;506;5;501;481;115;38;93;2;19;103;131;0
BIZKAIA;82;SANTURTZI;4;4;U;542;260;2;258;5;253;282;66;25;42;0;6;50;64;0
BIZKAIA;82;SANTURTZI;4;5;U;653;314;0;314;3;311;339;74;23;50;0;4;63;95;2
BIZKAIA;82;SANTURTZI;5;1;U;705;287;2;285;2;283;418;53;18;34;3;19;68;86;2
BIZKAIA;82;SANTURTZI;5;2;A;513;255;3;252;3;249;258;39;11;43;0;3;47;105;1
BIZKAIA;82;SANTURTZI;5;2;B;588;268;1;267;0;267;320;49;17;20;2;4;39;135;1
BIZKAIA;83;ORTUELLA;1;1;U;993;556;2;554;4;550;437;127;47;73;0;33;78;192;0
BIZKAIA;83;ORTUELLA;1;2;A;796;463;3;460;7;453;333;99;24;67;0;24;94;145;0
BIZKAIA;83;ORTUELLA;1;2;B;893;554;0;554;10;544;339;127;42;50;2;16;142;165;0
BIZKAIA;83;ORTUELLA;1;3;A;499;339;0;339;3;336;160;87;28;28;0;16;73;104;0
BIZKAIA;83;ORTUELLA;1;3;B;525;338;2;336;5;331;187;71;26;27;1;27;59;120;0
BIZKAIA;83;ORTUELLA;1;4;U;763;460;2;458;5;453;303;120;37;35;0;16;97;147;1
BIZKAIA;83;ORTUELLA;1;5;A;761;463;11;452;6;446;298;146;25;43;0;41;71;120;0
BIZKAIA;83;ORTUELLA;1;5;B;896;551;3;548;7;541;345;176;36;59;1;53;81;135;0
BIZKAIA;83;ORTUELLA;2;1;A;747;469;2;467;1;466;278;146;27;65;1;28;63;134;2
BIZKAIA;83;ORTUELLA;2;1;B;213;151;0;151;6;145;62;50;8;25;0;21;10;31;0
BIZKAIA;84;SESTAO;1;1;A;698;403;3;400;6;394;295;73;48;48;0;26;85;114;0
BIZKAIA;84;SESTAO;1;1;B;799;475;1;474;8;466;324;104;50;44;1;28;88;151;0
BIZKAIA;84;SESTAO;1;2;A;567;351;3;348;6;342;216;97;55;32;0;15;59;83;1
BIZKAIA;84;SESTAO;1;2;B;749;440;2;438;5;433;309;111;61;43;2;25;78;112;1
BIZKAIA;84;SESTAO;1;3;A;754;458;0;458;4;454;296;119;97;37;3;27;56;114;1
BIZKAIA;84;SESTAO;1;3;B;803;469;0;469;5;464;334;102;97;45;0;29;72;118;1
BIZKAIA;84;SESTAO;1;4;A;672;350;1;349;6;343;322;76;50;36;1;6;59;114;1
BIZKAIA;84;SESTAO;1;4;B;708;413;0;413;6;407;295;89;70;35;2;10;97;104;0
BIZKAIA;84;SESTAO;1;5;U;722;433;1;432;3;429;289;141;61;52;1;15;50;109;0
BIZKAIA;84;SESTAO;1;6;A;652;323;0;323;2;321;329;78;51;20;1;8;58;105;0
BIZKAIA;84;SESTAO;1;6;B;752;421;4;417;4;413;331;84;70;11;3;14;84;146;1
BIZKAIA;84;SESTAO;1;7;U;1206;718;3;715;9;706;488;164;108;54;2;31;125;222;0
BIZKAIA;84;SESTAO;1;8;U;1105;653;1;652;8;644;452;154;121;45;0;25;106;193;0
BIZKAIA;84;SESTAO;2;1;U;950;507;1;506;10;496;443;141;59;64;1;25;83;123;0
BIZKAIA;84;SESTAO;2;2;U;1120;611;2;609;8;601;509;164;63;63;0;45;118;146;2
BIZKAIA;84;SESTAO;2;3;U;1133;726;9;717;10;707;407;194;92;93;0;27;131;170;0
BIZKAIA;84;SESTAO;2;4;A;524;293;0;293;6;287;231;75;22;49;0;22;48;71;0
BIZKAIA;84;SESTAO;2;4;B;645;361;0;361;6;355;284;95;30;50;0;19;61;100;0
BIZKAIA;84;SESTAO;2;5;U;1153;617;1;616;12;604;536;101;75;73;0;24;154;176;1
BIZKAIA;84;SESTAO;2;6;U;874;461;3;458;11;447;413;95;62;32;1;22;93;142;0
BIZKAIA;84;SESTAO;3;1;U;870;520;6;514;5;509;350;134;68;56;1;20;88;142;0
BIZKAIA;84;SESTAO;3;2;U;1012;521;5;516;5;511;491;124;63;60;0;14;109;141;0
BIZKAIA;84;SESTAO;3;3;U;835;395;3;392;10;382;440;77;28;45;2;14;79;137;0
BIZKAIA;84;SESTAO;3;4;U;1052;501;3;498;4;494;551;108;43;59;2;22;90;170;0
BIZKAIA;84;SESTAO;3;5;U;922;445;1;444;8;436;477;95;60;49;1;14;73;141;3
BIZKAIA;84;SESTAO;3;6;U;740;450;2;448;5;443;290;117;49;53;1;15;84;123;1
BIZKAIA;84;SESTAO;4;1;A;655;383;2;381;5;376;272;71;59;25;0;15;72;133;1
BIZKAIA;84;SESTAO;4;1;B;640;352;2;350;3;347;288;69;52;43;0;9;72;102;0
BIZKAIA;84;SESTAO;4;2;A;814;400;2;398;11;387;414;59;54;47;1;8;108;108;2
BIZKAIA;84;SESTAO;4;2;B;865;444;0;444;10;434;421;84;56;49;1;6;108;130;0
BIZKAIA;84;SESTAO;4;3;A;815;424;3;421;10;411;391;92;44;32;3;8;83;148;1
BIZKAIA;84;SESTAO;4;3;B;979;528;13;515;12;503;451;87;61;46;3;9;130;167;0
BIZKAIA;84;SESTAO;4;4;A;781;341;5;336;5;331;440;57;25;38;1;14;86;109;1
BIZKAIA;84;SESTAO;4;4;B;799;376;2;374;2;372;423;70;27;64;1;12;76;119;3
BIZKAIA;84;SESTAO;4;5;U;1190;583;3;580;20;560;607;117;60;48;2;26;105;202;0
BIZKAIA;85;SOPELANA;1;1;A;883;550;8;542;17;525;333;257;49;97;2;38;47;34;1
BIZKAIA;85;SOPELANA;1;1;B;788;464;9;455;6;449;324;204;37;103;1;25;36;43;0
BIZKAIA;85;SOPELANA;1;2;A;757;475;12;463;0;463;282;203;25;102;0;27;48;57;1
BIZKAIA;85;SOPELANA;1;2;B;718;426;4;422;4;418;292;161;20;95;1;23;64;54;0
BIZKAIA;85;SOPELANA;1;3;A;584;348;3;345;6;339;236;124;25;91;0;23;22;54;0
BIZKAIA;85;SOPELANA;1;3;B;583;341;0;341;8;333;242;116;41;58;1;24;42;51;0
BIZKAIA;85;SOPELANA;1;4;A;690;431;1;430;6;424;259;144;40;111;0;37;33;59;0
BIZKAIA;85;SOPELANA;1;4;B;657;422;4;418;11;407;235;156;32;86;0;40;37;55;1
BIZKAIA;85;SOPELANA;1;5;A;652;402;0;402;10;392;250;192;26;77;0;36;33;28;0
BIZKAIA;85;SOPELANA;1;5;B;593;340;2;338;9;329;253;151;33;73;0;31;30;11;0
BIZKAIA;86;SOPUERTA;1;1;U;904;615;0;615;9;606;289;214;51;65;0;187;29;60;0
BIZKAIA;86;SOPUERTA;1;2;U;926;601;3;598;10;588;325;229;50;69;3;68;36;133;0
BIZKAIA;87;TRUCIOS-TURTZIOZ;1;1;U;441;310;9;301;1;300;131;186;46;18;0;16;3;31;0
BIZKAIA;88;UBIDE;1;1;U;137;124;0;124;1;123;13;48;13;53;0;5;4;0;0
BIZKAIA;89;URDULIZ;1;1;A;778;556;6;550;15;535;222;259;20;136;0;46;27;47;0
BIZKAIA;89;URDULIZ;1;1;B;688;453;2;451;3;448;235;215;36;95;0;29;20;52;1
BIZKAIA;89;URDULIZ;1;2;U;700;492;2;490;4;486;208;286;29;95;0;33;14;29;0
BIZKAIA;90;BALMASEDA;1;1;A;537;348;6;342;4;338;189;153;36;41;1;35;5;67;0
BIZKAIA;90;BALMASEDA;1;1;B;708;444;3;441;6;435;264;179;47;50;1;47;13;98;0
BIZKAIA;90;BALMASEDA;1;2;U;686;459;2;457;7;450;227;183;61;54;1;45;21;84;1
BIZKAIA;90;BALMASEDA;1;3;U;810;542;4;538;7;531;268;220;74;51;1;26;24;135;0
BIZKAIA;90;BALMASEDA;1;4;U;968;637;6;631;7;624;331;249;79;77;1;49;31;137;1
BIZKAIA;90;BALMASEDA;2;1;A;529;371;4;367;3;364;158;174;33;32;2;20;18;84;1
BIZKAIA;90;BALMASEDA;2;1;B;627;440;0;440;8;432;187;195;32;39;2;31;23;109;1
BIZKAIA;90;BALMASEDA;2;2;A;586;370;1;369;9;360;216;135;39;39;1;16;23;107;0
BIZKAIA;90;BALMASEDA;2;2;B;682;405;3;402;5;397;277;164;34;41;1;34;11;112;0
BIZKAIA;91;ATXONDO;1;1;A;951;622;3;619;18;601;329;299;34;148;7;27;34;51;1
BIZKAIA;91;ATXONDO;1;1;B;216;172;0;172;2;170;44;109;4;41;0;13;3;0;0
BIZKAIA;92;BEDIA;1;1;U;869;696;0;696;3;693;173;458;43;95;0;40;21;36;0
BIZKAIA;93;AREATZA;1;1;U;935;721;17;704;7;697;214;367;91;119;2;52;25;40;1
BIZKAIA;94;IGORRE;1;1;A;982;721;8;713;0;713;261;400;45;152;3;70;12;31;0
BIZKAIA;94;IGORRE;1;1;B;795;562;2;560;5;555;233;312;27;114;0;45;13;43;1
BIZKAIA;94;IGORRE;1;2;A;641;482;4;478;7;471;159;226;8;116;1;89;14;17;0
BIZKAIA;94;IGORRE;1;2;B;566;457;5;452;5;447;109;237;17;85;0;100;4;3;1
BIZKAIA;95;ZALDIBAR;1;1;A;575;333;4;329;4;325;242;130;36;66;0;38;7;48;0
BIZKAIA;95;ZALDIBAR;1;1;B;451;253;2;251;2;249;198;75;28;50;1;26;25;44;0
BIZKAIA;95;ZALDIBAR;1;2;U;622;367;3;364;3;361;255;120;55;78;1;21;28;57;1
BIZKAIA;95;ZALDIBAR;1;3;U;809;457;3;454;1;453;352;119;69;67;1;29;46;122;0
BIZKAIA;96;ZALLA;1;1;A;783;587;12;575;9;566;196;321;43;54;1;47;42;58;0
BIZKAIA;96;ZALLA;1;1;B;898;651;23;628;6;622;247;333;47;67;2;57;36;79;1
BIZKAIA;96;ZALLA;1;2;U;645;467;3;464;3;461;178;292;20;65;1;29;8;46;0
BIZKAIA;96;ZALLA;1;3;A;648;475;5;470;6;464;173;231;26;38;3;39;35;92;0
BIZKAIA;96;ZALLA;1;3;B;735;505;5;500;8;492;230;260;21;44;4;49;33;81;0
BIZKAIA;96;ZALLA;1;4;U;560;459;6;453;6;447;101;290;28;26;0;25;20;58;0
BIZKAIA;96;ZALLA;2;1;A;806;556;10;546;8;538;250;307;45;31;1;40;29;85;0
BIZKAIA;96;ZALLA;2;1;B;885;631;8;623;12;611;254;386;47;40;0;46;16;76;0
BIZKAIA;97;ZARATAMO;1;1;U;616;442;3;439;4;435;174;187;19;141;1;54;20;12;1
BIZKAIA;97;ZARATAMO;1;2;U;682;461;1;460;7;453;221;140;13;67;1;95;35;101;1
BIZKAIA;901;DERIO;1;1;A;906;572;6;566;14;552;334;224;35;69;0;59;35;130;0
BIZKAIA;901;DERIO;1;1;B;998;610;5;605;13;592;388;226;70;85;1;35;44;131;0
BIZKAIA;901;DERIO;1;2;U;733;522;6;516;7;509;211;288;48;57;0;52;21;43;0
BIZKAIA;901;DERIO;1;3;A;648;407;5;402;13;389;241;140;32;37;0;22;40;117;1
BIZKAIA;901;DERIO;1;3;B;685;432;8;424;9;415;253;144;34;54;3;20;33;126;1
BIZKAIA;902;ERANDIO;1;1;A;680;375;2;373;5;368;305;154;27;52;3;28;28;76;0
BIZKAIA;902;ERANDIO;1;1;B;652;362;0;362;5;357;290;126;35;56;0;31;33;76;0
BIZKAIA;902;ERANDIO;1;2;U;564;352;0;352;4;348;212;158;25;42;1;35;22;64;1
BIZKAIA;902;ERANDIO;1;3;U;1013;532;1;531;9;522;481;193;68;74;0;24;54;108;1
BIZKAIA;902;ERANDIO;1;4;U;928;496;4;492;7;485;432;182;41;88;1;21;46;103;3
BIZKAIA;902;ERANDIO;1;5;U;845;473;1;472;14;458;372;185;43;77;0;25;37;91;0
BIZKAIA;902;ERANDIO;1;6;U;750;373;0;373;8;365;377;137;46;48;1;34;24;73;2
BIZKAIA;902;ERANDIO;1;7;U;1046;543;4;539;12;527;503;169;36;77;3;41;68;131;2
BIZKAIA;902;ERANDIO;1;8;U;1326;697;3;694;12;682;629;220;78;105;1;48;92;133;5
BIZKAIA;902;ERANDIO;1;9;U;757;434;3;431;6;425;323;175;30;50;1;32;48;89;0
BIZKAIA;902;ERANDIO;2;1;U;878;463;4;459;6;453;415;115;48;69;2;26;72;119;2
BIZKAIA;902;ERANDIO;2;2;A;691;373;3;370;5;365;318;109;51;48;0;17;61;78;1
BIZKAIA;902;ERANDIO;2;2;B;696;380;4;376;4;372;316;114;43;50;3;28;57;75;2
BIZKAIA;902;ERANDIO;2;3;A;767;411;1;410;6;404;356;103;55;50;0;17;64;115;0
BIZKAIA;902;ERANDIO;2;3;B;638;350;0;350;4;346;288;83;48;35;1;27;53;97;2
BIZKAIA;902;ERANDIO;2;4;U;1034;508;2;506;7;499;526;136;59;71;5;25;83;119;1
BIZKAIA;902;ERANDIO;2;5;U;755;413;1;412;7;405;342;136;53;53;1;17;56;87;2
BIZKAIA;902;ERANDIO;2;6;U;907;465;4;461;4;457;442;131;42;68;5;20;60;130;1
BIZKAIA;902;ERANDIO;2;7;U;656;315;1;314;7;307;341;74;46;46;3;12;36;90;0
BIZKAIA;902;ERANDIO;2;8;U;1224;635;2;633;10;623;589;201;68;80;5;34;96;137;2
BIZKAIA;902;ERANDIO;3;1;U;546;283;0;283;3;280;263;105;24;56;2;12;26;54;1
BIZKAIA;902;ERANDIO;3;2;U;499;373;8;365;3;362;126;243;25;44;0;36;8;6;0
BIZKAIA;902;ERANDIO;3;3;U;525;302;1;301;6;295;223;141;14;89;2;23;7;19;0
BIZKAIA;902;ERANDIO;3;4;U;496;347;0;347;4;343;149;195;19;60;0;30;10;29;0
BIZKAIA;902;ERANDIO;3;5;U;739;474;0;474;3;471;265;310;25;82;0;44;8;2;0
BIZKAIA;903;LOIU;1;1;A;1119;809;1;808;13;795;310;456;142;72;0;94;18;13;0
BIZKAIA;903;LOIU;1;1;B;390;268;2;266;4;262;122;167;23;31;0;33;3;5;0
BIZKAIA;904;SONDIKA;1;1;A;723;523;3;520;11;509;200;302;30;63;1;36;21;56;0
BIZKAIA;904;SONDIKA;1;1;B;724;513;9;504;9;495;211;285;46;55;4;17;19;69;0
BIZKAIA;904;SONDIKA;1;2;A;564;412;3;409;5;404;152;231;30;62;1;53;10;17;0
BIZKAIA;904;SONDIKA;1;2;B;445;320;4;316;8;308;125;192;15;44;0;31;9;17;0
BIZKAIA;904;SONDIKA;1;3;U;542;387;6;381;13;368;155;220;50;30;0;24;21;22;1
BIZKAIA;905;ZAMUDIO;1;1;U;1054;766;14;752;6;746;288;423;35;188;0;30;17;53;0
BIZKAIA;905;ZAMUDIO;1;2;U;527;368;3;365;1;364;159;228;17;68;0;32;7;12;0
BIZKAIA;905;ZAMUDIO;1;3;U;985;658;10;648;21;627;327;299;26;109;3;25;34;127;4
BIZKAIA;906;FORUA;1;1;U;763;543;0;543;1;542;220;237;27;168;0;70;6;34;0
BIZKAIA;907;KORTEZUBI;1;1;U;321;268;4;264;1;263;53;174;6;57;0;19;2;5;0
BIZKAIA;908;MURUETA;1;1;U;168;122;0;122;5;117;46;71;3;22;0;21;0;0;0
BIZKAIA;909;NABARNIZ;1;1;U;218;180;1;179;3;176;38;77;0;84;0;14;1;0;0
BIZKAIA;910;IURRETA;1;1;A;326;257;1;256;0;256;69;140;11;81;0;9;4;10;1
BIZKAIA;910;IURRETA;1;1;B;487;367;0;367;3;364;120;200;12;105;0;17;7;23;0
BIZKAIA;910;IURRETA;1;1;C;204;140;0;140;2;138;64;96;5;20;0;9;2;6;0
BIZKAIA;910;IURRETA;1;2;A;453;286;2;284;3;281;167;84;33;57;1;17;9;80;0
BIZKAIA;910;IURRETA;1;2;B;533;315;5;310;1;309;218;88;47;37;5;10;27;95;0
BIZKAIA;910;IURRETA;1;3;A;957;546;3;543;12;531;411;174;54;106;1;21;54;121;0
BIZKAIA;910;IURRETA;1;3;B;901;524;4;520;8;512;377;141;95;71;0;23;45;136;1
BIZKAIA;911;AJANGIZ;1;1;U;304;253;0;253;2;251;51;108;1;108;0;32;2;0;0
BIZKAIA;912;ALONSOTEGI;1;1;U;945;707;9;698;11;687;238;282;44;88;0;143;25;105;0
BIZKAIA;912;ALONSOTEGI;1;2;U;601;493;8;485;6;479;108;232;40;57;0;81;15;54;0
BIZKAIA;912;ALONSOTEGI;1;3;A;695;534;13;521;4;517;161;221;39;85;1;112;28;31;0
BIZKAIA;912;ALONSOTEGI;1;3;B;298;216;2;214;1;213;82;39;14;48;0;65;5;42;0
BIZKAIA;914;ARRATZU;1;1;U;327;275;1;274;3;271;52;103;1;128;0;35;0;4;0
BIZKAIA;999;MUNICIPIO CERA BIZKAIA;1;1;U;7514;1629;11;1618;6;1612;5885;637;192;149;8;62;95;458;11
