TH;CODMUN;AMBITO;DISTRITO;SECCION;MESA;CENSO;VOTANTES;NULOS;VALIDOS;BLANCOS;VOTOS_CANDIDATOS;ABSTENCIONES;EAJ-PNV;PP;PH;EK-PCPE;PSE-EE/PSOE;PACMA/ATTKA;PFYV;CS;EB-AZ;O.E.;EH BILDU;VOX;GANEMOS;LN;PODEMOS/AHAL DUGU-IU;RECORTES CERO-GV
BIZKAIA;1;ABADIÑO;1;1;A;627;432;0;432;1;431;195;155;10;0;0;18;5;0;4;2;0;196;;0;;41;0
BIZKAIA;1;ABADIÑO;1;1;B;474;306;0;306;0;306;168;119;13;1;0;6;0;0;4;0;0;133;;0;;30;0
BIZKAIA;1;ABADIÑO;1;2;A;541;326;2;324;0;324;215;129;29;0;1;51;2;1;8;0;0;77;;1;;24;1
BIZKAIA;1;ABADIÑO;1;2;B;484;285;1;284;0;284;199;89;33;0;0;53;2;0;9;0;1;55;;3;;38;1
BIZKAIA;1;ABADIÑO;1;3;U;898;553;2;551;2;549;345;199;66;1;0;95;9;2;17;0;1;81;;5;;72;1
BIZKAIA;1;ABADIÑO;1;4;A;791;478;0;478;4;474;313;138;7;0;0;26;5;1;7;2;1;215;;3;;67;2
BIZKAIA;1;ABADIÑO;1;4;B;630;403;1;402;3;399;227;138;8;1;1;17;6;1;3;1;0;164;;5;;54;0
BIZKAIA;1;ABADIÑO;1;5;A;722;455;0;455;4;451;267;184;43;0;0;55;3;0;11;1;0;101;;0;;52;1
BIZKAIA;1;ABADIÑO;1;5;B;674;467;3;464;3;461;207;151;39;0;0;61;4;1;9;0;0;118;;7;;71;0
BIZKAIA;2;ABANTO Y CIÉRVANA-ABANTO ZIERBENA;1;1;A;751;488;3;485;4;481;263;183;10;0;0;81;5;1;9;4;0;82;;2;;102;2
BIZKAIA;2;ABANTO Y CIÉRVANA-ABANTO ZIERBENA;1;1;B;803;513;3;510;3;507;290;210;14;0;0;72;4;0;7;2;0;85;;1;;112;0
BIZKAIA;2;ABANTO Y CIÉRVANA-ABANTO ZIERBENA;1;2;U;889;506;8;498;5;493;383;198;12;0;0;67;2;0;5;0;0;111;;0;;98;0
BIZKAIA;2;ABANTO Y CIÉRVANA-ABANTO ZIERBENA;1;4;U;609;394;2;392;2;390;215;179;9;0;2;55;1;0;5;2;1;57;;1;;77;1
BIZKAIA;2;ABANTO Y CIÉRVANA-ABANTO ZIERBENA;1;5;A;557;359;3;356;4;352;198;120;7;0;0;34;7;0;5;0;0;57;;3;;119;0
BIZKAIA;2;ABANTO Y CIÉRVANA-ABANTO ZIERBENA;1;5;B;649;459;2;457;3;454;190;156;13;0;0;55;5;0;4;1;0;71;;7;;141;1
BIZKAIA;2;ABANTO Y CIÉRVANA-ABANTO ZIERBENA;2;1;A;486;338;4;334;1;333;148;152;7;0;1;28;1;0;3;0;0;64;;2;;74;1
BIZKAIA;2;ABANTO Y CIÉRVANA-ABANTO ZIERBENA;2;1;B;563;408;3;405;2;403;155;177;9;0;0;39;2;0;4;0;0;90;;0;;82;0
BIZKAIA;2;ABANTO Y CIÉRVANA-ABANTO ZIERBENA;2;2;A;512;320;3;317;2;315;192;137;8;0;0;28;4;0;2;2;0;59;;1;;74;0
BIZKAIA;2;ABANTO Y CIÉRVANA-ABANTO ZIERBENA;2;2;B;517;332;3;329;5;324;185;129;13;0;0;36;4;0;13;0;0;61;;1;;67;0
BIZKAIA;2;ABANTO Y CIÉRVANA-ABANTO ZIERBENA;2;3;A;693;486;6;480;2;478;207;196;28;0;0;71;3;3;5;0;0;61;;5;;106;0
BIZKAIA;2;ABANTO Y CIÉRVANA-ABANTO ZIERBENA;2;3;B;778;485;4;481;1;480;293;205;20;1;1;81;0;0;11;1;0;58;;4;;98;0
BIZKAIA;3;AMOREBIETA-ETXANO;1;1;A;810;560;7;553;1;552;250;284;22;0;1;31;1;0;2;1;0;158;;2;;49;1
BIZKAIA;3;AMOREBIETA-ETXANO;1;1;B;642;447;1;446;1;445;195;232;28;2;0;30;2;2;6;0;0;103;;2;;38;0
BIZKAIA;3;AMOREBIETA-ETXANO;1;2;A;744;481;2;479;4;475;263;200;14;0;0;32;11;1;7;2;1;133;;2;;71;1
BIZKAIA;3;AMOREBIETA-ETXANO;1;2;B;696;444;2;442;3;439;252;178;21;1;0;47;3;1;8;0;0;92;;3;;82;3
BIZKAIA;3;AMOREBIETA-ETXANO;1;3;A;596;380;2;378;0;378;216;149;12;1;0;23;1;0;2;0;0;137;;2;;51;0
BIZKAIA;3;AMOREBIETA-ETXANO;1;3;B;481;314;0;314;0;314;167;140;20;2;0;17;1;0;2;0;0;84;;0;;47;1
BIZKAIA;3;AMOREBIETA-ETXANO;1;4;A;665;419;2;417;4;413;246;136;20;1;0;68;2;3;3;1;1;93;;4;;79;2
BIZKAIA;3;AMOREBIETA-ETXANO;1;4;B;638;338;4;334;0;334;300;120;21;0;0;53;3;0;8;1;0;58;;1;;66;3
BIZKAIA;3;AMOREBIETA-ETXANO;1;5;A;863;618;5;613;2;611;245;298;21;2;0;26;2;0;4;1;0;189;;1;;66;1
BIZKAIA;3;AMOREBIETA-ETXANO;1;5;B;655;473;2;471;5;466;182;246;13;0;0;11;6;1;2;0;0;129;;4;;54;0
BIZKAIA;3;AMOREBIETA-ETXANO;1;6;A;699;434;1;433;5;428;265;153;10;0;1;44;1;1;8;0;1;116;;5;;85;3
BIZKAIA;3;AMOREBIETA-ETXANO;1;6;B;699;426;1;425;1;424;273;155;16;0;0;62;3;0;6;1;1;107;;1;;72;0
BIZKAIA;3;AMOREBIETA-ETXANO;1;7;A;660;507;4;503;0;503;153;291;15;0;1;9;2;0;2;1;0;141;;2;;39;0
BIZKAIA;3;AMOREBIETA-ETXANO;1;7;B;496;346;1;345;1;344;150;192;13;1;0;22;1;0;4;1;0;67;;1;;41;1
BIZKAIA;3;AMOREBIETA-ETXANO;1;8;A;572;384;0;384;2;382;188;147;6;0;1;20;5;1;4;0;0;155;;0;;43;0
BIZKAIA;3;AMOREBIETA-ETXANO;1;8;B;501;318;2;316;2;314;183;119;11;0;0;37;2;1;2;0;0;89;;0;;52;1
BIZKAIA;3;AMOREBIETA-ETXANO;1;9;A;691;445;5;440;1;439;246;187;12;0;0;33;4;2;4;0;0;125;;1;;70;1
BIZKAIA;3;AMOREBIETA-ETXANO;1;9;B;592;367;0;367;3;364;225;140;12;0;1;60;3;0;4;0;0;72;;2;;69;1
BIZKAIA;3;AMOREBIETA-ETXANO;1;10;A;743;508;3;505;2;503;235;231;13;0;0;48;2;0;5;0;0;123;;3;;76;2
BIZKAIA;3;AMOREBIETA-ETXANO;1;10;B;671;450;2;448;2;446;221;187;17;0;0;37;4;1;7;0;0;104;;1;;88;0
BIZKAIA;3;AMOREBIETA-ETXANO;2;1;A;268;183;0;183;1;182;85;88;9;1;0;2;0;0;0;0;0;72;;0;;9;1
BIZKAIA;3;AMOREBIETA-ETXANO;2;1;B;279;189;1;188;0;188;90;99;2;0;0;4;0;0;0;1;0;55;;0;;27;0
BIZKAIA;3;AMOREBIETA-ETXANO;3;1;U;653;486;0;486;4;482;167;280;4;0;0;11;2;0;3;0;0;148;;0;;34;0
BIZKAIA;4;AMOROTO;1;1;U;334;240;0;240;0;240;94;121;0;0;0;0;0;2;0;0;0;113;;0;;4;0
BIZKAIA;5;ARAKALDO;1;1;U;112;68;1;67;0;67;44;29;1;0;0;2;1;0;0;1;0;23;;1;;9;0
BIZKAIA;6;ARANTZAZU;1;1;U;295;238;0;238;0;238;57;102;1;0;0;1;0;0;0;0;0;115;;0;;19;0
BIZKAIA;7;MUNITIBAR-ARBATZEGI GERRIKAITZ-;1;1;U;363;255;0;255;3;252;108;119;0;0;0;0;1;0;0;0;0;121;;0;;11;0
BIZKAIA;8;ARTZENTALES;1;1;U;612;430;6;424;1;423;182;269;8;0;0;16;2;1;0;0;0;78;;4;;43;2
BIZKAIA;9;ARRANKUDIAGA;1;1;U;776;599;5;594;8;586;177;275;11;0;0;9;3;1;7;0;0;246;;1;;32;1
BIZKAIA;10;ARRIETA;1;1;U;456;329;2;327;1;326;127;191;1;0;0;4;1;1;3;1;0;98;;1;;25;0
BIZKAIA;11;ARRIGORRIAGA;1;1;U;908;528;2;526;2;524;380;172;30;1;0;65;1;1;8;0;1;138;;6;;101;0
BIZKAIA;11;ARRIGORRIAGA;1;2;A;873;493;3;490;3;487;380;178;29;1;1;61;9;0;14;1;0;87;;3;;101;2
BIZKAIA;11;ARRIGORRIAGA;1;2;B;869;505;5;500;5;495;364;188;30;0;1;73;10;3;16;0;0;73;;2;;97;2
BIZKAIA;11;ARRIGORRIAGA;1;3;A;608;348;3;345;3;342;260;113;15;0;0;68;6;0;7;0;0;69;;0;;63;1
BIZKAIA;11;ARRIGORRIAGA;1;3;B;487;246;0;246;0;246;241;76;21;0;0;44;1;0;2;0;0;46;;2;;53;1
BIZKAIA;11;ARRIGORRIAGA;1;4;A;917;620;1;619;4;615;297;264;17;0;0;49;5;1;6;0;1;149;;4;;119;0
BIZKAIA;11;ARRIGORRIAGA;1;4;B;900;622;8;614;6;608;278;251;28;2;0;50;2;0;7;0;0;104;;5;;159;0
BIZKAIA;11;ARRIGORRIAGA;2;1;U;731;503;5;498;6;492;228;237;24;0;0;42;2;1;10;1;0;96;;3;;75;1
BIZKAIA;11;ARRIGORRIAGA;2;2;A;524;306;2;304;0;304;218;124;19;0;0;33;7;0;1;1;0;84;;3;;31;1
BIZKAIA;11;ARRIGORRIAGA;2;2;B;476;290;1;289;4;285;186;118;21;2;0;19;2;0;6;0;1;58;;2;;56;0
BIZKAIA;11;ARRIGORRIAGA;2;3;A;687;474;4;470;1;469;213;213;21;1;0;30;1;0;11;0;1;124;;1;;66;0
BIZKAIA;11;ARRIGORRIAGA;2;3;B;557;364;6;358;2;356;193;143;17;1;0;34;4;0;8;1;0;93;;4;;50;1
BIZKAIA;11;ARRIGORRIAGA;2;4;A;544;354;3;351;3;348;190;136;11;0;0;24;4;0;9;0;0;92;;2;;70;0
BIZKAIA;11;ARRIGORRIAGA;2;4;B;574;360;0;360;3;357;214;128;16;0;0;38;3;0;3;1;0;78;;4;;85;1
BIZKAIA;12;BAKIO;1;1;A;439;333;2;331;2;329;106;156;9;0;0;6;5;0;1;0;0;120;;2;;30;0
BIZKAIA;12;BAKIO;1;1;B;411;309;3;306;2;304;102;138;5;0;0;8;2;0;1;0;0;122;;1;;26;1
BIZKAIA;12;BAKIO;1;2;A;660;497;4;493;3;490;163;273;20;0;0;5;2;1;3;0;0;141;;3;;41;1
BIZKAIA;12;BAKIO;1;2;B;530;402;2;400;4;396;128;221;10;0;0;3;2;1;3;0;0;122;;0;;32;2
BIZKAIA;13;BARAKALDO;1;1;U;631;404;0;404;1;403;227;154;78;1;1;52;3;1;9;0;0;41;;1;;62;0
BIZKAIA;13;BARAKALDO;1;2;U;775;465;0;465;3;462;310;149;59;0;0;81;3;1;15;1;0;60;;7;;86;0
BIZKAIA;13;BARAKALDO;1;3;U;763;473;6;467;2;465;290;161;76;0;1;81;4;1;7;0;2;48;;5;;79;0
BIZKAIA;13;BARAKALDO;1;4;A;530;290;3;287;6;281;240;127;36;0;0;36;3;0;6;0;0;23;;1;;49;0
BIZKAIA;13;BARAKALDO;1;4;B;640;383;0;383;0;383;257;155;51;1;0;63;1;0;11;1;0;35;;5;;58;2
BIZKAIA;13;BARAKALDO;1;5;U;730;460;1;459;5;454;270;164;51;0;0;98;2;1;7;0;0;45;;5;;79;2
BIZKAIA;13;BARAKALDO;1;6;U;684;363;2;361;1;360;321;123;41;0;1;72;1;1;8;1;0;33;;7;;71;1
BIZKAIA;13;BARAKALDO;1;7;U;498;287;1;286;2;284;211;67;36;0;0;75;2;0;6;2;0;27;;1;;67;1
BIZKAIA;13;BARAKALDO;1;8;A;493;278;0;278;0;278;215;74;42;0;0;49;4;0;6;0;0;38;;2;;62;1
BIZKAIA;13;BARAKALDO;1;8;B;497;314;0;314;0;314;183;108;39;0;0;57;6;0;9;1;0;33;;3;;57;1
BIZKAIA;13;BARAKALDO;2;1;U;825;466;4;462;1;461;359;172;38;0;0;75;5;0;9;0;0;63;;5;;89;5
BIZKAIA;13;BARAKALDO;2;2;U;942;568;2;566;3;563;374;209;80;1;0;109;7;3;11;1;0;41;;3;;95;3
BIZKAIA;13;BARAKALDO;2;3;U;722;377;2;375;1;374;345;132;37;1;0;56;5;0;5;0;0;58;;2;;76;2
BIZKAIA;13;BARAKALDO;2;4;A;519;307;0;307;2;305;212;91;27;0;1;58;3;1;11;0;0;35;;4;;72;2
BIZKAIA;13;BARAKALDO;2;4;B;637;354;3;351;4;347;283;119;37;0;1;57;4;2;10;0;0;34;;4;;79;0
BIZKAIA;13;BARAKALDO;2;5;U;780;403;2;401;2;399;377;145;37;0;1;64;8;0;6;1;0;46;;6;;83;2
BIZKAIA;13;BARAKALDO;2;6;A;493;266;3;263;1;262;227;89;26;0;0;48;3;0;4;0;0;31;;3;;56;2
BIZKAIA;13;BARAKALDO;2;6;B;548;267;1;266;1;265;281;86;38;0;2;43;2;2;4;1;0;28;;1;;56;2
BIZKAIA;13;BARAKALDO;2;7;U;513;298;1;297;3;294;215;85;35;0;0;72;3;1;3;0;0;29;;2;;64;0
BIZKAIA;13;BARAKALDO;2;8;A;628;365;3;362;2;360;263;134;28;0;1;63;2;0;10;1;0;31;;3;;86;1
BIZKAIA;13;BARAKALDO;2;8;B;620;368;4;364;2;362;252;118;45;0;0;67;5;0;18;1;0;29;;2;;77;0
BIZKAIA;13;BARAKALDO;2;9;U;892;521;5;516;3;513;371;186;48;0;0;120;7;0;9;3;0;38;;8;;94;0
BIZKAIA;13;BARAKALDO;2;10;A;453;248;1;247;2;245;205;77;22;0;3;32;2;3;8;1;0;35;;1;;61;0
BIZKAIA;13;BARAKALDO;2;10;B;551;322;1;321;7;314;229;107;37;1;1;62;6;2;7;0;0;34;;2;;53;2
BIZKAIA;13;BARAKALDO;2;11;A;875;543;5;538;3;535;332;209;46;0;0;87;7;2;16;1;0;48;;2;;116;1
BIZKAIA;13;BARAKALDO;2;11;B;961;638;1;637;3;634;323;239;46;0;1;115;5;1;18;1;0;50;;3;;151;4
BIZKAIA;13;BARAKALDO;3;1;U;780;398;0;398;4;394;382;122;52;0;0;63;6;0;5;0;0;47;;1;;97;1
BIZKAIA;13;BARAKALDO;3;2;A;513;279;0;279;0;279;234;95;27;0;0;57;1;1;13;0;0;32;;1;;52;0
BIZKAIA;13;BARAKALDO;3;2;B;544;301;2;299;7;292;243;95;33;0;1;75;0;1;7;1;0;25;;1;;52;1
BIZKAIA;13;BARAKALDO;3;3;U;655;346;1;345;6;339;309;109;43;0;1;65;6;0;3;0;0;42;;1;;67;2
BIZKAIA;13;BARAKALDO;3;4;U;840;469;2;467;8;459;371;131;57;0;0;97;6;0;12;2;1;38;;5;;106;4
BIZKAIA;13;BARAKALDO;3;5;U;627;347;2;345;0;345;280;119;52;0;0;53;3;1;13;0;0;36;;2;;66;0
BIZKAIA;13;BARAKALDO;3;6;U;644;351;2;349;3;346;293;117;31;0;1;58;3;0;5;1;0;53;;3;;74;0
BIZKAIA;13;BARAKALDO;3;7;U;577;334;0;334;0;334;243;92;32;0;0;95;7;0;7;0;0;22;;3;;74;2
BIZKAIA;13;BARAKALDO;3;8;U;801;509;4;505;1;504;292;169;52;0;3;99;9;3;6;0;0;33;;5;;122;3
BIZKAIA;13;BARAKALDO;4;1;U;758;400;3;397;2;395;358;133;41;0;0;81;5;0;16;0;1;45;;0;;72;1
BIZKAIA;13;BARAKALDO;4;2;U;532;336;1;335;2;333;196;131;50;0;0;63;0;1;5;1;1;33;;0;;48;0
BIZKAIA;13;BARAKALDO;4;3;U;748;432;3;429;2;427;316;130;43;0;0;67;3;2;16;2;1;65;;2;;96;0
BIZKAIA;13;BARAKALDO;4;4;U;902;525;1;524;5;519;377;170;40;0;1;92;6;0;14;2;0;74;;5;;115;0
BIZKAIA;13;BARAKALDO;4;5;U;550;305;3;302;6;296;245;82;41;1;0;64;2;0;5;0;1;43;;4;;50;3
BIZKAIA;13;BARAKALDO;4;6;U;612;377;0;377;2;375;235;122;40;0;0;54;6;0;4;0;0;47;;3;;96;3
BIZKAIA;13;BARAKALDO;4;7;A;512;295;0;295;2;293;217;91;27;0;0;81;2;0;5;0;0;31;;1;;55;0
BIZKAIA;13;BARAKALDO;4;7;B;507;291;2;289;6;283;216;77;36;0;0;66;0;1;3;0;0;26;;4;;69;1
BIZKAIA;13;BARAKALDO;4;8;A;455;283;3;280;2;278;172;84;15;0;1;54;4;1;12;0;1;43;;3;;59;1
BIZKAIA;13;BARAKALDO;4;8;B;523;342;2;340;2;338;181;103;23;0;0;67;3;0;7;0;0;61;;2;;72;0
BIZKAIA;13;BARAKALDO;4;9;U;759;420;1;419;2;417;339;133;41;0;0;77;5;0;7;1;0;79;;1;;73;0
BIZKAIA;13;BARAKALDO;4;10;U;787;469;4;465;0;465;318;134;37;0;0;104;6;0;5;0;0;69;;7;;102;1
BIZKAIA;13;BARAKALDO;4;11;A;531;338;2;336;3;333;193;99;38;1;0;61;2;3;17;0;0;33;;2;;75;2
BIZKAIA;13;BARAKALDO;4;11;B;546;344;0;344;2;342;202;122;33;0;1;54;3;0;7;0;0;35;;1;;86;0
BIZKAIA;13;BARAKALDO;5;1;A;702;446;2;444;2;442;256;169;60;1;0;65;1;0;9;1;0;51;;6;;78;1
BIZKAIA;13;BARAKALDO;5;1;B;850;540;0;540;4;536;310;191;84;0;2;77;6;0;16;2;0;67;;2;;87;2
BIZKAIA;13;BARAKALDO;5;2;A;565;354;0;354;1;353;211;101;38;0;0;83;3;0;9;0;0;59;;1;;57;2
BIZKAIA;13;BARAKALDO;5;2;B;595;349;4;345;1;344;246;98;46;1;0;93;3;0;7;0;0;39;;5;;52;0
BIZKAIA;13;BARAKALDO;5;3;U;679;411;4;407;3;404;268;135;35;0;2;73;6;1;2;0;0;53;;2;;95;0
BIZKAIA;13;BARAKALDO;5;4;U;579;335;1;334;1;333;244;116;45;0;0;51;2;1;12;0;0;34;;1;;70;1
BIZKAIA;13;BARAKALDO;5;5;A;871;589;0;589;3;586;282;233;81;0;0;108;3;0;24;1;0;53;;1;;80;2
BIZKAIA;13;BARAKALDO;5;5;B;854;587;1;586;2;584;267;227;98;0;1;101;2;0;19;0;0;42;;3;;89;2
BIZKAIA;13;BARAKALDO;5;6;A;497;293;1;292;4;288;204;104;33;0;0;63;2;0;5;0;0;43;;0;;36;2
BIZKAIA;13;BARAKALDO;5;6;B;509;308;2;306;3;303;201;114;43;0;0;51;3;0;3;0;0;28;;1;;60;0
BIZKAIA;13;BARAKALDO;5;7;A;472;309;1;308;2;306;163;93;45;0;0;68;3;0;16;0;0;20;;1;;58;2
BIZKAIA;13;BARAKALDO;5;7;B;534;339;2;337;8;329;195;110;60;0;0;64;0;0;8;2;0;28;;0;;56;1
BIZKAIA;13;BARAKALDO;5;8;A;472;258;0;258;1;257;214;87;12;0;1;63;2;1;3;1;0;27;;1;;59;0
BIZKAIA;13;BARAKALDO;5;8;B;479;280;1;279;1;278;199;73;23;0;0;67;1;2;6;0;0;45;;1;;60;0
BIZKAIA;13;BARAKALDO;5;9;A;512;315;2;313;3;310;197;101;22;0;0;52;1;1;5;0;0;45;;8;;74;1
BIZKAIA;13;BARAKALDO;5;9;B;577;362;0;362;3;359;215;121;22;0;0;47;4;0;8;0;1;45;;6;;103;2
BIZKAIA;13;BARAKALDO;5;10;U;868;516;3;513;4;509;352;130;41;1;0;113;2;3;10;2;1;74;;1;;130;1
BIZKAIA;13;BARAKALDO;5;11;A;520;300;1;299;1;298;220;106;24;2;0;45;3;1;8;4;0;25;;6;;70;4
BIZKAIA;13;BARAKALDO;5;11;B;578;332;0;332;3;329;246;127;21;2;0;47;3;2;6;2;0;22;;10;;87;0
BIZKAIA;13;BARAKALDO;6;1;A;632;357;2;355;1;354;275;99;51;1;0;90;3;1;13;1;0;27;;3;;62;3
BIZKAIA;13;BARAKALDO;6;1;B;714;313;3;310;2;308;401;129;48;0;3;80;3;1;13;1;0;28;;2;;0;0
BIZKAIA;13;BARAKALDO;6;2;U;763;422;0;422;4;418;341;150;47;0;0;79;2;1;13;1;0;36;;4;;84;1
BIZKAIA;13;BARAKALDO;6;3;U;853;525;1;524;4;520;328;171;86;0;1;99;2;2;13;2;0;31;;4;;107;2
BIZKAIA;13;BARAKALDO;6;4;U;945;550;6;544;3;541;395;186;65;0;0;126;5;2;13;0;1;41;;2;;100;0
BIZKAIA;13;BARAKALDO;6;5;U;941;530;3;527;3;524;411;185;60;0;0;99;4;2;14;3;1;51;;3;;102;0
BIZKAIA;13;BARAKALDO;6;6;U;616;336;1;335;3;332;280;97;19;0;0;75;4;0;4;3;0;45;;5;;80;0
BIZKAIA;13;BARAKALDO;6;7;A;443;219;2;217;0;217;224;46;6;0;0;54;4;0;2;1;0;32;;1;;71;0
BIZKAIA;13;BARAKALDO;6;7;B;524;255;0;255;1;254;269;81;15;0;1;53;7;0;3;1;0;30;;0;;63;0
BIZKAIA;13;BARAKALDO;6;8;U;803;486;1;485;3;482;317;147;75;0;0;117;5;2;4;0;0;38;;5;;86;3
BIZKAIA;13;BARAKALDO;6;9;U;820;499;2;497;2;495;321;143;52;0;1;97;3;2;21;0;1;70;;4;;101;0
BIZKAIA;13;BARAKALDO;6;10;A;522;339;0;339;1;338;183;102;35;0;1;73;3;0;12;0;0;39;;5;;66;2
BIZKAIA;13;BARAKALDO;6;10;B;503;348;2;346;2;344;155;120;39;0;0;77;3;0;13;1;0;21;;6;;64;0
BIZKAIA;13;BARAKALDO;6;11;U;910;522;2;520;4;516;388;166;64;1;0;101;4;0;9;1;0;61;;5;;104;0
BIZKAIA;13;BARAKALDO;6;12;A;490;271;0;271;1;270;219;97;19;1;1;41;5;0;2;0;3;29;;1;;71;0
BIZKAIA;13;BARAKALDO;6;12;B;504;261;2;259;1;258;243;74;23;0;1;44;1;0;7;0;0;29;;7;;72;0
BIZKAIA;13;BARAKALDO;6;13;U;767;430;1;429;4;425;337;149;51;2;0;92;5;1;5;0;0;38;;4;;77;1
BIZKAIA;13;BARAKALDO;7;1;A;680;390;2;388;1;387;290;138;37;0;0;78;3;0;10;1;0;36;;1;;82;1
BIZKAIA;13;BARAKALDO;7;1;B;726;378;2;376;1;375;348;154;42;0;1;59;2;1;5;1;0;37;;4;;67;2
BIZKAIA;13;BARAKALDO;7;2;U;951;494;0;494;2;492;457;173;37;1;0;105;8;0;14;1;0;63;;1;;88;1
BIZKAIA;13;BARAKALDO;7;3;A;826;509;0;509;2;507;317;169;51;0;0;112;6;1;9;0;1;38;;4;;114;2
BIZKAIA;13;BARAKALDO;7;3;B;894;551;2;549;3;546;343;194;43;1;0;120;5;0;21;1;0;45;;5;;110;1
BIZKAIA;13;BARAKALDO;7;4;A;822;475;0;475;5;470;347;178;36;0;2;67;3;0;7;0;0;58;;5;;113;1
BIZKAIA;13;BARAKALDO;7;4;B;467;293;4;289;1;288;174;137;10;0;0;20;5;0;10;0;0;52;;0;;53;1
BIZKAIA;13;BARAKALDO;7;5;A;601;368;1;367;4;363;233;127;20;0;3;61;4;2;10;3;1;35;;4;;92;1
BIZKAIA;13;BARAKALDO;7;5;B;673;380;1;379;2;377;293;152;20;0;3;54;2;2;9;1;0;40;;2;;92;0
BIZKAIA;13;BARAKALDO;8;1;U;829;506;4;502;4;498;323;180;18;0;2;74;9;3;9;0;0;97;;3;;103;0
BIZKAIA;13;BARAKALDO;8;2;A;681;388;2;386;0;386;293;127;18;0;1;67;10;1;9;0;1;67;;5;;79;1
BIZKAIA;13;BARAKALDO;8;2;B;649;344;1;343;2;341;305;120;15;0;1;44;7;0;2;0;0;63;;3;;85;1
BIZKAIA;13;BARAKALDO;8;3;U;901;492;2;490;3;487;409;184;22;0;1;73;4;0;6;2;0;79;;7;;109;0
BIZKAIA;13;BARAKALDO;8;4;A;517;310;2;308;0;308;207;102;32;0;0;77;3;0;8;1;0;17;;3;;64;1
BIZKAIA;13;BARAKALDO;8;4;B;488;285;0;285;2;283;203;96;26;0;0;68;3;0;7;0;0;18;;1;;64;0
BIZKAIA;13;BARAKALDO;8;5;U;661;399;4;395;3;392;262;141;33;0;0;94;2;2;6;2;0;31;;3;;78;0
BIZKAIA;13;BARAKALDO;8;6;U;711;417;0;417;0;417;294;136;31;1;0;113;2;0;15;0;0;33;;2;;83;1
BIZKAIA;13;BARAKALDO;8;7;A;509;292;2;290;3;287;217;88;40;0;0;40;1;0;4;0;0;34;;4;;76;0
BIZKAIA;13;BARAKALDO;8;7;B;572;341;3;338;2;336;231;136;33;1;0;45;1;1;4;1;0;43;;2;;68;1
BIZKAIA;13;BARAKALDO;8;8;A;618;289;1;288;4;284;329;76;18;0;1;53;5;0;4;0;0;47;;4;;74;2
BIZKAIA;13;BARAKALDO;8;8;B;208;130;0;130;2;128;78;68;4;0;0;6;0;0;1;0;0;29;;1;;18;1
BIZKAIA;13;BARAKALDO;9;1;U;717;434;6;428;10;418;283;150;53;0;1;77;2;2;9;1;0;37;;3;;83;0
BIZKAIA;13;BARAKALDO;9;2;U;808;466;4;462;3;459;342;158;66;0;0;93;4;1;17;0;1;31;;1;;87;0
BIZKAIA;13;BARAKALDO;9;3;U;791;391;4;387;2;385;400;147;37;0;0;71;3;1;10;0;1;36;;2;;77;0
BIZKAIA;13;BARAKALDO;9;4;U;874;504;4;500;3;497;370;169;66;0;0;96;4;3;7;0;0;38;;4;;105;5
BIZKAIA;13;BARAKALDO;9;5;U;815;444;0;444;3;441;371;156;29;2;1;85;5;1;6;1;0;64;;2;;87;2
BIZKAIA;13;BARAKALDO;9;6;U;551;309;0;309;3;306;242;97;22;1;1;69;3;0;4;2;0;33;;2;;71;1
BIZKAIA;13;BARAKALDO;9;7;A;683;415;5;410;0;410;268;132;38;0;0;93;2;0;11;0;0;35;;6;;91;2
BIZKAIA;13;BARAKALDO;9;7;B;743;443;0;443;5;438;300;168;43;1;1;89;2;0;3;2;0;50;;2;;76;1
BIZKAIA;13;BARAKALDO;9;8;U;853;497;5;492;2;490;356;166;27;0;0;79;10;0;17;1;0;79;;1;;109;1
BIZKAIA;13;BARAKALDO;9;9;A;519;300;2;298;1;297;219;91;32;0;0;66;6;0;12;0;0;30;;0;;59;1
BIZKAIA;13;BARAKALDO;9;9;B;514;306;0;306;4;302;208;102;28;0;0;57;1;0;12;0;0;31;;0;;67;4
BIZKAIA;13;BARAKALDO;9;10;A;493;305;0;305;1;304;188;89;38;0;0;71;8;1;8;1;0;26;;4;;58;0
BIZKAIA;13;BARAKALDO;9;10;B;525;300;4;296;2;294;225;78;48;1;0;67;1;1;7;0;0;29;;2;;60;0
BIZKAIA;13;BARAKALDO;9;11;U;616;371;0;371;2;369;245;115;19;0;0;79;3;1;8;0;0;54;;0;;86;4
BIZKAIA;13;BARAKALDO;9;12;U;762;463;2;461;4;457;299;165;34;0;0;86;6;0;6;2;0;51;;3;;103;1
BIZKAIA;14;BARRIKA;1;1;A;624;387;4;383;1;382;237;166;29;0;0;15;4;1;11;1;0;105;;1;;49;0
BIZKAIA;14;BARRIKA;1;1;B;583;367;1;366;0;366;216;182;21;0;0;28;0;0;1;1;0;83;;0;;48;2
BIZKAIA;15;BASAURI;1;1;A;512;310;0;310;0;310;202;124;28;1;0;45;2;1;2;0;0;48;;3;;55;1
BIZKAIA;15;BASAURI;1;1;B;461;264;0;264;0;264;197;114;18;1;0;42;5;0;2;0;0;31;;3;;47;1
BIZKAIA;15;BASAURI;1;2;U;847;450;2;448;3;445;397;147;52;1;1;73;8;1;15;0;1;38;;6;;100;2
BIZKAIA;15;BASAURI;1;3;U;683;430;2;428;3;425;253;179;42;4;0;62;6;0;9;1;0;60;;3;;59;0
BIZKAIA;15;BASAURI;1;4;U;805;474;6;468;1;467;331;221;48;0;1;58;3;1;9;0;0;58;;0;;67;1
BIZKAIA;15;BASAURI;1;5;U;847;501;1;500;1;499;346;226;55;0;0;91;0;1;13;0;0;31;;4;;78;0
BIZKAIA;15;BASAURI;1;6;A;505;286;0;286;0;286;219;128;23;0;0;34;5;2;9;2;0;33;;0;;48;2
BIZKAIA;15;BASAURI;1;6;B;531;257;1;256;3;253;274;89;31;0;1;48;6;0;8;2;0;27;;1;;39;1
BIZKAIA;15;BASAURI;1;7;U;727;420;1;419;2;417;307;131;42;1;2;82;8;1;15;1;0;42;;4;;87;1
BIZKAIA;15;BASAURI;1;8;A;552;305;0;305;3;302;247;115;30;0;0;74;1;1;4;1;0;25;;4;;46;1
BIZKAIA;15;BASAURI;1;8;B;520;318;2;316;0;316;202;108;43;0;0;81;5;0;7;1;0;22;;2;;45;2
BIZKAIA;15;BASAURI;1;9;A;624;339;0;339;3;336;285;125;40;0;0;71;3;1;6;1;0;23;;4;;62;0
BIZKAIA;15;BASAURI;1;9;B;659;388;2;386;3;383;271;144;52;2;0;77;4;1;11;0;0;37;;2;;53;0
BIZKAIA;15;BASAURI;1;10;A;705;390;1;389;5;384;315;137;51;1;0;72;4;1;7;0;0;38;;1;;72;0
BIZKAIA;15;BASAURI;1;10;B;671;397;0;397;0;397;274;133;38;0;0;93;3;3;9;0;0;42;;3;;72;1
BIZKAIA;15;BASAURI;1;11;A;533;274;2;272;2;270;259;97;33;0;0;64;1;0;7;0;0;24;;0;;42;2
BIZKAIA;15;BASAURI;1;11;B;538;311;0;311;1;310;227;106;32;0;0;89;1;1;7;0;0;19;;5;;48;2
BIZKAIA;15;BASAURI;1;12;U;750;460;1;459;3;456;290;186;27;1;0;61;7;0;11;0;0;75;;1;;86;1
BIZKAIA;15;BASAURI;2;2;A;629;406;3;403;1;402;223;190;43;2;0;44;2;2;5;1;0;59;;1;;53;0
BIZKAIA;15;BASAURI;2;2;B;565;362;2;360;2;358;203;161;30;0;0;31;4;1;5;1;0;60;;1;;63;1
BIZKAIA;15;BASAURI;2;3;U;779;544;4;540;2;538;235;268;52;0;0;62;3;0;9;0;1;82;;2;;57;2
BIZKAIA;15;BASAURI;2;4;U;840;479;6;473;2;471;361;185;49;0;0;84;1;0;15;0;0;68;;6;;62;1
BIZKAIA;15;BASAURI;2;5;U;744;469;0;469;1;468;275;194;48;0;1;68;5;0;6;0;0;74;;3;;69;0
BIZKAIA;15;BASAURI;2;6;U;677;381;2;379;0;379;296;156;37;1;0;76;3;0;8;0;0;41;;5;;52;0
BIZKAIA;15;BASAURI;2;7;U;723;435;3;432;3;429;288;184;41;0;0;70;3;0;2;0;0;53;;2;;74;0
BIZKAIA;15;BASAURI;2;8;U;643;410;0;410;2;408;233;172;44;0;0;58;4;1;3;0;0;62;;6;;58;0
BIZKAIA;15;BASAURI;2;9;U;543;344;5;339;2;337;199;131;25;0;0;62;4;1;6;0;0;62;;2;;43;1
BIZKAIA;15;BASAURI;2;10;A;593;363;0;363;0;363;230;137;36;1;1;50;6;3;13;0;0;63;;1;;52;0
BIZKAIA;15;BASAURI;2;10;B;659;398;1;397;5;392;261;148;37;0;0;77;2;2;8;0;1;49;;2;;63;3
BIZKAIA;15;BASAURI;2;11;U;605;352;0;352;0;352;253;138;35;0;0;55;2;1;5;0;0;52;;1;;62;1
BIZKAIA;15;BASAURI;2;12;U;838;514;1;513;1;512;324;285;37;0;1;61;4;0;9;1;0;47;;0;;66;1
BIZKAIA;15;BASAURI;2;13;A;691;424;1;423;1;422;267;161;34;0;0;62;5;1;5;0;0;64;;3;;86;1
BIZKAIA;15;BASAURI;2;13;B;630;367;0;367;2;365;263;149;21;0;1;59;4;1;8;2;1;54;;3;;61;1
BIZKAIA;15;BASAURI;2;14;U;712;394;2;392;2;390;318;150;21;0;0;59;3;1;4;0;0;81;;2;;68;1
BIZKAIA;15;BASAURI;2;15;U;860;577;2;575;1;574;283;250;69;0;1;106;4;1;12;1;0;61;;3;;66;0
BIZKAIA;15;BASAURI;2;16;A;697;397;1;396;4;392;300;172;22;0;1;43;4;2;8;0;0;58;;1;;80;1
BIZKAIA;15;BASAURI;2;16;B;620;371;0;371;2;369;249;134;21;1;0;61;2;3;9;0;1;54;;6;;77;0
BIZKAIA;15;BASAURI;2;17;U;530;374;3;371;0;371;156;211;27;0;0;26;2;3;12;1;0;50;;0;;37;2
BIZKAIA;15;BASAURI;2;18;U;540;338;1;337;0;337;202;111;36;0;0;96;1;1;7;0;0;45;;0;;40;0
BIZKAIA;15;BASAURI;3;1;A;572;349;1;348;1;347;223;136;39;1;0;66;4;0;6;0;0;40;;1;;52;2
BIZKAIA;15;BASAURI;3;1;B;516;312;2;310;1;309;204;120;29;0;0;83;1;1;5;0;0;26;;3;;41;0
BIZKAIA;15;BASAURI;3;2;A;494;258;0;258;1;257;236;92;28;1;0;62;1;0;2;1;0;30;;3;;37;0
BIZKAIA;15;BASAURI;3;2;B;509;289;0;289;0;289;220;96;43;1;1;64;1;0;5;1;1;30;;2;;44;0
BIZKAIA;15;BASAURI;3;3;U;692;417;0;417;3;414;275;195;38;0;0;59;4;1;6;2;0;52;;1;;54;2
BIZKAIA;15;BASAURI;4;1;U;570;287;0;287;0;287;283;126;32;1;2;29;1;1;4;1;1;38;;2;;47;2
BIZKAIA;15;BASAURI;4;2;A;572;344;0;344;4;340;228;137;32;0;0;60;1;0;7;1;0;42;;6;;52;2
BIZKAIA;15;BASAURI;4;2;B;555;351;1;350;2;348;204;120;23;1;1;88;7;2;15;0;0;34;;0;;57;0
BIZKAIA;15;BASAURI;5;1;U;814;504;2;502;5;497;310;251;15;1;0;35;7;2;2;1;0;102;;4;;76;1
BIZKAIA;15;BASAURI;5;2;U;875;557;0;557;2;555;318;246;25;0;2;70;5;0;2;0;0;80;;5;;119;1
BIZKAIA;15;BASAURI;5;3;U;911;520;6;514;8;506;391;194;34;0;2;48;6;0;6;0;0;89;;2;;124;1
BIZKAIA;15;BASAURI;5;4;U;860;590;2;588;5;583;270;235;25;0;0;80;4;2;11;0;0;96;;3;;126;1
BIZKAIA;16;BERANGO;1;1;A;534;354;0;354;1;353;180;158;17;0;0;36;4;2;9;3;0;77;;5;;42;0
BIZKAIA;16;BERANGO;1;1;B;494;328;1;327;1;326;166;131;20;0;0;34;6;0;10;0;0;78;;1;;44;2
BIZKAIA;16;BERANGO;1;2;U;968;680;3;677;2;675;288;303;52;0;0;38;2;1;14;0;1;152;;3;;107;2
BIZKAIA;16;BERANGO;1;3;A;687;481;2;479;3;476;206;219;61;0;0;34;6;2;19;1;0;76;;1;;57;0
BIZKAIA;16;BERANGO;1;3;B;648;417;2;415;1;414;231;174;51;0;0;36;4;0;12;0;0;86;;2;;48;1
BIZKAIA;16;BERANGO;1;4;U;934;600;4;596;5;591;334;254;62;0;1;36;3;3;15;1;0;123;;2;;89;2
BIZKAIA;16;BERANGO;1;5;A;487;307;0;307;4;303;180;104;30;0;0;30;2;1;10;2;0;71;;4;;49;0
BIZKAIA;16;BERANGO;1;5;B;551;344;0;344;4;340;207;119;21;0;0;53;4;0;6;2;0;58;;0;;75;2
BIZKAIA;17;BERMEO;1;1;A;582;347;0;347;1;346;235;165;6;0;0;17;1;1;3;2;0;128;;0;;22;1
BIZKAIA;17;BERMEO;1;1;B;451;257;2;255;1;254;194;114;5;0;1;18;2;0;1;0;1;76;;2;;33;1
BIZKAIA;17;BERMEO;1;2;U;622;355;4;351;0;351;267;163;4;0;1;16;2;0;3;0;1;114;;1;;46;0
BIZKAIA;17;BERMEO;1;3;A;493;302;1;301;0;301;191;157;5;0;0;2;5;0;0;0;0;102;;1;;29;0
BIZKAIA;17;BERMEO;1;3;B;462;283;1;282;2;280;179;139;3;0;0;7;1;0;4;0;1;93;;2;;30;0
BIZKAIA;17;BERMEO;2;1;U;940;660;0;660;1;659;280;374;7;1;0;7;2;0;4;1;0;210;;1;;52;0
BIZKAIA;17;BERMEO;2;2;A;787;2;1;1;1;0;785;0;0;0;0;0;0;0;0;0;0;0;;0;;0;0
BIZKAIA;17;BERMEO;2;2;B;750;455;2;453;2;451;295;230;12;0;0;16;3;1;2;2;1;129;;0;;55;0
BIZKAIA;17;BERMEO;2;3;A;689;395;0;395;0;395;294;228;3;0;0;10;4;0;4;0;0;121;;1;;24;0
BIZKAIA;17;BERMEO;2;3;B;615;361;3;358;2;356;254;203;5;0;0;12;3;0;2;1;0;94;;1;;34;1
BIZKAIA;17;BERMEO;2;4;U;919;547;2;545;1;544;372;325;13;1;1;9;3;1;3;2;0;128;;2;;56;0
BIZKAIA;17;BERMEO;2;5;U;741;464;0;464;1;463;277;248;10;0;0;24;3;3;5;0;0;115;;7;;48;0
BIZKAIA;17;BERMEO;2;6;U;661;458;4;454;0;454;203;310;1;0;0;3;1;1;2;3;0;114;;2;;17;0
BIZKAIA;17;BERMEO;3;1;U;874;542;4;538;2;536;332;246;13;1;0;22;4;1;6;0;0;177;;0;;65;1
BIZKAIA;17;BERMEO;3;2;A;857;597;2;595;2;593;260;310;5;0;0;21;3;0;2;1;0;192;;2;;56;1
BIZKAIA;17;BERMEO;3;2;B;712;499;0;499;3;496;213;235;4;0;1;17;3;0;1;3;0;167;;1;;63;1
BIZKAIA;17;BERMEO;3;3;A;800;583;1;582;1;581;217;338;9;0;1;12;1;0;2;0;0;185;;1;;32;0
BIZKAIA;17;BERMEO;3;3;B;636;454;0;454;2;452;182;277;14;0;0;4;0;0;5;0;0;125;;0;;27;0
BIZKAIA;17;BERMEO;3;4;U;668;402;0;402;4;398;266;209;9;0;0;15;3;1;1;0;0;125;;0;;34;1
BIZKAIA;18;BERRIATUA;1;1;U;875;571;0;571;2;569;304;258;2;2;0;3;3;1;1;0;1;277;;1;;20;0
BIZKAIA;19;BERRIZ;1;1;U;824;481;2;479;1;478;343;186;21;2;0;56;5;0;10;0;0;126;;3;;69;0
BIZKAIA;19;BERRIZ;1;2;U;660;448;0;448;2;446;212;202;18;2;0;6;1;0;1;2;1;176;;0;;36;1
BIZKAIA;19;BERRIZ;1;3;A;597;380;2;378;2;376;217;151;19;1;0;41;2;0;6;1;0;94;;3;;58;0
BIZKAIA;19;BERRIZ;1;3;B;507;312;1;311;4;307;195;121;16;0;1;36;7;0;1;0;0;71;;0;;53;1
BIZKAIA;19;BERRIZ;1;4;A;494;329;3;326;4;322;165;124;12;0;0;38;3;0;9;1;0;86;;3;;45;1
BIZKAIA;19;BERRIZ;1;4;B;455;309;0;309;1;308;146;131;10;0;0;42;4;2;4;0;0;74;;2;;38;1
BIZKAIA;20;BILBAO;1;2;U;920;569;3;566;11;555;351;221;44;0;1;68;7;1;14;2;0;83;;6;;105;3
BIZKAIA;20;BILBAO;1;3;U;607;397;2;395;2;393;210;153;46;0;0;42;3;1;8;0;1;51;;4;;84;0
BIZKAIA;20;BILBAO;1;5;U;981;600;1;599;7;592;381;256;61;0;0;66;7;1;22;0;0;76;;2;;100;1
BIZKAIA;20;BILBAO;1;6;U;1164;712;2;710;11;699;452;246;100;0;0;112;11;2;10;6;1;87;;8;;116;0
BIZKAIA;20;BILBAO;1;7;U;719;461;3;458;3;455;258;183;38;2;0;72;8;1;14;3;1;51;;2;;80;0
BIZKAIA;20;BILBAO;1;8;U;534;330;1;329;1;328;204;130;30;0;0;38;7;0;10;2;0;40;;2;;68;1
BIZKAIA;20;BILBAO;1;9;U;932;553;0;553;7;546;379;199;61;0;3;79;7;1;10;2;0;78;;12;;93;1
BIZKAIA;20;BILBAO;1;10;A;609;413;4;409;6;403;196;182;42;0;0;54;1;2;12;0;0;46;;2;;60;2
BIZKAIA;20;BILBAO;1;10;B;681;455;0;455;5;450;226;195;49;0;2;68;7;0;7;0;0;45;;3;;74;0
BIZKAIA;20;BILBAO;1;11;U;765;501;4;497;1;496;264;195;61;0;0;79;4;1;9;0;0;61;;7;;78;1
BIZKAIA;20;BILBAO;1;12;U;572;351;2;349;4;345;221;152;33;0;0;40;0;0;5;1;1;42;;2;;67;2
BIZKAIA;20;BILBAO;1;13;U;851;514;1;513;4;509;337;196;42;0;0;62;8;0;11;2;0;80;;2;;104;2
BIZKAIA;20;BILBAO;1;15;U;532;296;2;294;2;292;236;117;30;2;1;34;0;1;5;2;0;34;;4;;59;3
BIZKAIA;20;BILBAO;1;16;A;614;376;1;375;3;372;238;156;57;0;1;62;4;2;13;0;0;34;;0;;42;1
BIZKAIA;20;BILBAO;1;16;B;661;407;0;407;3;404;254;182;52;0;0;64;2;2;17;1;0;39;;2;;43;0
BIZKAIA;20;BILBAO;1;17;U;906;540;3;537;3;534;366;217;90;0;0;79;5;3;12;1;0;42;;3;;82;0
BIZKAIA;20;BILBAO;1;18;U;1106;717;3;714;3;711;389;301;87;0;0;120;3;1;20;1;0;68;;3;;104;3
BIZKAIA;20;BILBAO;1;19;U;851;505;2;503;4;499;346;221;56;1;0;69;5;3;15;2;0;67;;3;;57;0
BIZKAIA;20;BILBAO;1;20;U;1098;710;3;707;1;706;388;282;101;4;0;93;4;2;22;1;0;88;;1;;106;2
BIZKAIA;20;BILBAO;1;21;U;783;447;2;445;5;440;336;180;39;0;0;54;13;1;9;2;0;55;;1;;84;2
BIZKAIA;20;BILBAO;1;22;A;657;438;1;437;2;435;219;170;58;1;0;63;7;0;9;1;0;57;;2;;65;2
BIZKAIA;20;BILBAO;1;22;B;659;409;0;409;2;407;250;158;60;0;0;57;1;2;12;4;0;39;;4;;70;0
BIZKAIA;20;BILBAO;1;23;A;638;412;3;409;3;406;226;179;45;0;0;52;4;0;12;1;0;47;;2;;63;1
BIZKAIA;20;BILBAO;1;23;B;621;399;1;398;1;397;222;164;44;0;0;59;2;0;14;0;0;60;;3;;50;1
BIZKAIA;20;BILBAO;1;25;A;632;440;2;438;4;434;192;223;52;1;0;34;6;2;14;0;1;55;;0;;46;0
BIZKAIA;20;BILBAO;1;25;B;659;449;0;449;3;446;210;204;72;0;0;43;8;1;14;0;0;37;;2;;65;0
BIZKAIA;20;BILBAO;1;26;U;1193;768;5;763;7;756;425;334;78;0;1;91;2;1;21;1;2;109;;8;;107;1
BIZKAIA;20;BILBAO;1;27;U;1068;651;3;648;7;641;417;185;60;1;2;134;12;2;22;1;0;67;;1;;151;3
BIZKAIA;20;BILBAO;1;28;U;1039;593;3;590;2;588;446;173;64;0;0;124;6;0;11;0;0;66;;7;;133;4
BIZKAIA;20;BILBAO;1;29;A;621;361;5;356;3;353;260;120;21;0;1;81;3;1;8;0;0;50;;3;;64;1
BIZKAIA;20;BILBAO;1;29;B;621;361;2;359;4;355;260;103;34;0;1;77;4;0;11;2;0;56;;5;;62;0
BIZKAIA;20;BILBAO;1;30;A;632;445;0;445;3;442;187;205;45;0;0;55;4;0;9;0;0;74;;2;;48;0
BIZKAIA;20;BILBAO;1;30;B;641;437;4;433;2;431;204;213;45;0;0;36;5;0;11;0;0;58;;0;;63;0
BIZKAIA;20;BILBAO;1;31;U;990;614;2;612;3;609;376;267;63;1;1;61;4;1;21;2;0;101;;3;;82;2
BIZKAIA;20;BILBAO;1;32;U;1141;751;1;750;3;747;390;340;92;0;1;72;6;0;24;1;0;100;;1;;108;2
BIZKAIA;20;BILBAO;1;33;U;671;448;0;448;2;446;223;202;69;0;0;41;1;1;7;1;0;73;;2;;47;2
BIZKAIA;20;BILBAO;1;34;U;506;348;2;346;0;346;158;185;46;0;0;28;0;3;2;0;0;57;;0;;25;0
BIZKAIA;20;BILBAO;1;35;U;594;338;0;338;1;337;256;172;32;0;0;36;2;1;2;0;0;53;;3;;36;0
BIZKAIA;20;BILBAO;1;36;U;581;303;3;300;2;298;278;130;14;0;1;25;3;3;3;0;0;53;;0;;66;0
BIZKAIA;20;BILBAO;1;37;U;619;417;4;413;5;408;202;211;58;0;1;25;5;0;4;0;0;66;;3;;33;2
BIZKAIA;20;BILBAO;1;38;A;1081;785;1;784;6;778;296;389;82;0;2;85;5;5;15;3;0;99;;2;;91;0
BIZKAIA;20;BILBAO;1;38;B;332;201;4;197;2;195;131;49;6;0;0;10;3;0;3;0;0;82;;1;;41;0
BIZKAIA;20;BILBAO;1;39;U;531;339;7;332;3;329;192;164;51;0;0;35;4;0;2;0;0;34;;0;;36;3
BIZKAIA;20;BILBAO;1;40;U;591;420;2;418;1;417;171;202;55;0;0;45;1;2;5;0;0;57;;1;;48;1
BIZKAIA;20;BILBAO;1;41;U;906;571;0;571;3;568;335;252;81;1;1;52;4;0;8;2;0;85;;1;;78;3
BIZKAIA;20;BILBAO;1;42;A;812;575;1;574;5;569;237;258;93;1;0;63;2;1;6;1;0;76;;2;;66;0
BIZKAIA;20;BILBAO;1;42;B;755;521;1;520;4;516;234;220;67;1;2;82;4;2;16;1;0;65;;2;;53;1
BIZKAIA;20;BILBAO;1;43;U;713;482;2;480;1;479;231;249;70;0;1;41;8;5;8;1;0;46;;2;;48;0
BIZKAIA;20;BILBAO;1;44;U;1110;761;1;760;3;757;349;391;134;1;0;81;2;1;9;1;0;68;;1;;68;0
BIZKAIA;20;BILBAO;1;45;A;623;391;1;390;0;390;232;162;49;0;0;42;2;0;6;0;1;68;;4;;56;0
BIZKAIA;20;BILBAO;1;45;B;584;364;5;359;4;355;220;145;55;0;1;37;5;0;12;0;0;50;;2;;47;1
BIZKAIA;20;BILBAO;1;46;U;999;630;5;625;4;621;369;280;33;0;0;70;3;2;11;0;2;91;;7;;121;1
BIZKAIA;20;BILBAO;2;1;U;1056;593;2;591;0;591;463;222;106;0;1;83;3;0;17;0;0;74;;4;;80;1
BIZKAIA;20;BILBAO;2;2;U;582;342;1;341;1;340;240;112;78;0;0;25;3;0;13;2;0;45;;0;;62;0
BIZKAIA;20;BILBAO;2;3;A;630;381;3;378;2;376;249;159;47;0;0;41;10;0;10;1;0;39;;2;;65;2
BIZKAIA;20;BILBAO;2;3;B;638;373;1;372;5;367;265;152;42;0;0;48;10;0;11;0;0;42;;1;;60;1
BIZKAIA;20;BILBAO;2;5;U;863;470;0;470;3;467;393;184;59;0;0;78;6;1;17;0;0;50;;3;;69;0
BIZKAIA;20;BILBAO;2;6;U;638;363;1;362;5;357;275;117;45;0;0;90;1;1;5;0;1;39;;0;;57;1
BIZKAIA;20;BILBAO;2;7;U;628;372;0;372;2;370;256;147;47;0;0;59;2;0;5;2;0;39;;6;;61;2
BIZKAIA;20;BILBAO;2;8;U;664;427;0;427;0;427;237;199;39;0;0;50;2;1;7;0;0;55;;4;;69;1
BIZKAIA;20;BILBAO;2;9;U;696;385;3;382;1;381;311;127;58;0;1;64;3;0;9;3;1;49;;3;;62;1
BIZKAIA;20;BILBAO;2;10;U;624;363;4;359;1;358;261;136;51;0;2;72;1;2;9;3;0;39;;1;;41;1
BIZKAIA;20;BILBAO;2;11;U;1096;587;1;586;4;582;509;214;81;0;0;122;4;3;19;0;0;59;;1;;79;0
BIZKAIA;20;BILBAO;2;12;A;610;425;1;424;3;421;185;220;60;0;0;50;2;0;8;0;0;43;;5;;33;0
BIZKAIA;20;BILBAO;2;12;B;610;403;4;399;2;397;207;207;64;0;0;44;4;1;11;0;0;31;;2;;33;0
BIZKAIA;20;BILBAO;2;13;U;1051;560;3;557;2;555;491;234;26;0;0;79;12;6;10;1;0;83;;6;;96;2
BIZKAIA;20;BILBAO;2;14;U;708;373;1;372;1;371;335;157;39;0;0;50;4;1;9;1;0;30;;5;;75;0
BIZKAIA;20;BILBAO;2;15;U;788;538;1;537;4;533;250;266;72;0;0;56;5;0;16;1;0;63;;1;;53;0
BIZKAIA;20;BILBAO;2;16;U;888;546;2;544;2;542;342;238;64;0;0;80;2;1;8;1;0;72;;3;;70;3
BIZKAIA;20;BILBAO;2;18;U;786;479;0;479;2;477;307;216;39;0;0;67;5;0;16;0;1;53;;2;;78;0
BIZKAIA;20;BILBAO;2;19;U;1058;556;0;556;2;554;502;219;71;0;2;85;4;1;16;2;0;73;;2;;77;2
BIZKAIA;20;BILBAO;2;20;U;987;545;3;542;1;541;442;248;56;0;0;50;10;1;14;2;1;70;;5;;84;0
BIZKAIA;20;BILBAO;2;21;U;748;411;0;411;0;411;337;191;37;0;0;45;11;0;3;0;0;60;;2;;61;1
BIZKAIA;20;BILBAO;2;22;U;907;498;2;496;8;488;409;183;72;0;0;88;7;1;11;0;0;46;;3;;77;0
BIZKAIA;20;BILBAO;2;23;U;644;338;2;336;2;334;306;157;40;0;0;45;2;5;7;3;0;35;;1;;39;0
BIZKAIA;20;BILBAO;2;24;U;813;514;2;512;1;511;299;183;93;0;0;93;2;1;13;0;0;58;;1;;67;0
BIZKAIA;20;BILBAO;2;25;A;608;417;6;411;4;407;191;194;41;0;0;38;3;0;7;0;0;72;;5;;47;0
BIZKAIA;20;BILBAO;2;25;B;557;372;3;369;1;368;185;160;53;0;1;49;0;1;7;0;0;38;;6;;53;0
BIZKAIA;20;BILBAO;2;26;U;1172;807;1;806;2;804;365;342;74;1;3;93;7;4;18;3;0;141;;2;;115;1
BIZKAIA;20;BILBAO;2;27;U;791;494;1;493;4;489;297;223;48;0;0;33;11;3;9;0;1;82;;0;;77;2
BIZKAIA;20;BILBAO;2;28;U;582;360;1;359;3;356;222;141;24;1;1;34;5;1;8;3;0;63;;5;;67;3
BIZKAIA;20;BILBAO;2;29;U;926;479;1;478;3;475;447;182;64;0;0;87;5;0;9;0;0;50;;5;;73;0
BIZKAIA;20;BILBAO;2;30;U;810;525;3;522;6;516;285;237;77;0;0;55;2;3;14;0;0;63;;4;;60;1
BIZKAIA;20;BILBAO;2;31;A;665;453;0;453;5;448;212;207;103;1;0;36;1;0;13;1;0;39;;2;;43;2
BIZKAIA;20;BILBAO;2;31;B;619;395;1;394;0;394;224;158;102;0;0;41;3;0;23;0;0;26;;0;;40;1
BIZKAIA;20;BILBAO;2;32;U;1150;799;3;796;4;792;351;373;138;0;1;72;5;0;18;1;0;100;;2;;80;2
BIZKAIA;20;BILBAO;2;33;U;1085;749;6;743;2;741;336;368;120;1;0;53;2;1;27;1;0;78;;1;;88;1
BIZKAIA;20;BILBAO;2;34;U;926;559;3;556;4;552;367;236;77;0;0;64;4;2;13;2;0;61;;2;;88;3
BIZKAIA;20;BILBAO;2;35;U;580;390;3;387;3;384;190;178;46;1;0;42;1;3;5;1;0;62;;1;;43;1
BIZKAIA;20;BILBAO;3;1;A;736;440;0;440;2;438;296;186;26;0;0;68;4;1;15;0;0;57;;2;;77;2
BIZKAIA;20;BILBAO;3;1;B;744;457;0;457;5;452;287;175;32;0;0;83;2;3;10;0;0;58;;6;;83;0
BIZKAIA;20;BILBAO;3;2;U;935;455;3;452;3;449;480;146;60;1;0;88;5;0;10;1;1;45;;0;;92;0
BIZKAIA;20;BILBAO;3;3;U;935;490;0;490;2;488;445;145;50;1;1;127;7;1;6;5;0;47;;2;;95;1
BIZKAIA;20;BILBAO;3;5;A;693;312;2;310;0;310;381;115;27;2;0;75;1;1;2;0;0;28;;2;;57;0
BIZKAIA;20;BILBAO;3;5;B;634;283;3;280;3;277;351;75;31;0;0;48;2;2;2;0;3;45;;1;;67;1
BIZKAIA;20;BILBAO;3;6;U;630;246;2;244;2;242;384;91;15;1;0;49;5;0;2;0;0;22;;4;;53;0
BIZKAIA;20;BILBAO;3;7;U;755;309;0;309;3;306;446;96;25;0;0;73;2;0;2;1;0;34;;2;;69;2
BIZKAIA;20;BILBAO;3;8;U;501;202;3;199;1;198;299;89;11;0;1;31;2;0;1;1;0;30;;1;;31;0
BIZKAIA;20;BILBAO;3;9;U;847;391;3;388;1;387;456;125;14;0;0;71;4;1;4;2;6;68;;3;;88;1
BIZKAIA;20;BILBAO;3;10;U;568;228;0;228;2;226;340;68;23;1;3;57;2;0;3;0;0;27;;1;;40;1
BIZKAIA;20;BILBAO;3;11;U;1076;406;0;406;1;405;670;160;22;1;0;80;6;0;9;2;0;48;;2;;75;0
BIZKAIA;20;BILBAO;3;13;U;1042;725;1;724;9;715;317;253;99;0;0;106;10;1;30;2;0;88;;5;;121;0
BIZKAIA;20;BILBAO;3;14;U;678;450;1;449;2;447;228;204;64;0;0;72;2;1;10;0;0;35;;0;;59;0
BIZKAIA;20;BILBAO;3;15;U;861;438;0;438;5;433;423;174;37;1;0;77;2;0;9;0;0;54;;5;;73;1
BIZKAIA;20;BILBAO;3;16;U;989;687;0;687;4;683;302;312;77;0;0;80;4;1;10;1;1;128;;4;;65;0
BIZKAIA;20;BILBAO;3;17;A;692;416;1;415;5;410;276;147;45;0;0;49;4;0;11;2;1;72;;1;;77;1
BIZKAIA;20;BILBAO;3;17;B;633;371;0;371;4;367;262;140;38;0;0;57;5;0;9;0;0;43;;3;;71;1
BIZKAIA;20;BILBAO;3;18;U;1065;552;2;550;3;547;513;197;41;0;0;109;3;1;6;1;0;68;;11;;109;1
BIZKAIA;20;BILBAO;3;19;A;604;346;1;345;1;344;258;136;35;0;0;62;4;1;8;1;0;42;;2;;53;0
BIZKAIA;20;BILBAO;3;19;B;641;383;0;383;0;383;258;122;41;0;0;76;0;0;10;0;0;53;;5;;74;2
BIZKAIA;20;BILBAO;3;20;A;879;507;3;504;3;501;372;204;32;1;0;74;9;0;8;0;1;74;;9;;89;0
BIZKAIA;20;BILBAO;3;20;B;801;483;1;482;3;479;318;199;19;1;0;72;7;0;10;0;0;72;;4;;94;1
BIZKAIA;20;BILBAO;3;21;A;614;379;4;375;2;373;235;147;12;0;2;58;6;2;10;0;0;67;;4;;64;1
BIZKAIA;20;BILBAO;3;21;B;639;374;1;373;3;370;265;119;27;0;0;55;9;0;3;1;0;66;;3;;87;0
BIZKAIA;20;BILBAO;3;22;U;854;524;1;523;5;518;330;196;80;1;1;80;2;0;25;0;0;60;;1;;72;0
BIZKAIA;20;BILBAO;3;23;A;723;490;1;489;1;488;233;234;36;1;0;51;3;2;9;0;0;92;;2;;58;0
BIZKAIA;20;BILBAO;3;23;B;702;467;1;466;1;465;235;214;33;0;1;75;2;2;7;3;0;69;;2;;57;0
BIZKAIA;20;BILBAO;4;2;U;1045;672;7;665;6;659;373;303;82;0;0;74;10;0;13;1;0;92;;6;;74;4
BIZKAIA;20;BILBAO;4;3;A;640;437;1;436;1;435;203;230;51;0;0;54;4;1;6;1;0;51;;1;;35;1
BIZKAIA;20;BILBAO;4;3;B;608;387;1;386;3;383;221;191;54;0;2;34;1;2;11;2;0;47;;2;;37;0
BIZKAIA;20;BILBAO;4;5;U;843;570;2;568;5;563;273;252;65;1;0;71;4;3;21;0;0;87;;4;;55;0
BIZKAIA;20;BILBAO;4;6;U;889;545;1;544;3;541;344;254;74;0;0;64;2;1;11;3;0;70;;1;;60;1
BIZKAIA;20;BILBAO;4;8;A;721;417;4;413;5;408;304;175;40;0;0;49;4;0;8;0;1;72;;4;;53;2
BIZKAIA;20;BILBAO;4;8;B;687;392;0;392;2;390;295;157;66;0;1;33;7;3;6;1;0;44;;1;;69;2
BIZKAIA;20;BILBAO;4;9;U;979;596;0;596;3;593;383;284;66;0;0;65;1;2;9;0;0;93;;1;;72;0
BIZKAIA;20;BILBAO;4;10;A;753;474;1;473;0;473;279;188;54;0;0;89;7;0;11;0;1;65;;2;;56;0
BIZKAIA;20;BILBAO;4;10;B;697;428;1;427;0;427;269;204;59;0;0;47;4;1;5;0;0;55;;1;;51;0
BIZKAIA;20;BILBAO;4;12;A;613;399;0;399;2;397;214;163;53;0;2;60;1;1;4;0;0;63;;2;;48;0
BIZKAIA;20;BILBAO;4;12;B;585;376;1;375;2;373;209;148;55;0;0;60;3;0;3;0;0;48;;2;;52;2
BIZKAIA;20;BILBAO;4;13;U;899;608;7;601;6;595;291;254;86;0;0;74;3;2;10;4;0;90;;2;;69;1
BIZKAIA;20;BILBAO;4;14;A;706;459;2;457;1;456;247;218;66;0;0;51;3;1;8;1;0;58;;2;;47;1
BIZKAIA;20;BILBAO;4;14;B;649;430;0;430;4;426;219;170;72;0;0;72;4;1;10;3;0;51;;2;;40;1
BIZKAIA;20;BILBAO;4;15;U;926;608;1;607;3;604;318;233;81;1;0;88;3;0;22;2;1;79;;4;;89;1
BIZKAIA;20;BILBAO;4;16;U;669;432;0;432;1;431;237;195;57;0;0;49;5;0;3;0;0;70;;1;;51;0
BIZKAIA;20;BILBAO;4;17;U;615;427;0;427;4;423;188;183;53;1;1;58;5;0;8;0;0;59;;3;;51;1
BIZKAIA;20;BILBAO;4;18;U;674;405;0;405;3;402;269;163;59;1;0;60;1;3;11;2;0;48;;1;;52;1
BIZKAIA;20;BILBAO;4;19;U;762;461;0;461;1;460;301;203;42;0;1;91;4;0;5;0;1;50;;1;;62;0
BIZKAIA;20;BILBAO;4;20;U;647;409;0;409;2;407;238;176;55;0;0;55;5;0;2;0;1;55;;1;;56;1
BIZKAIA;20;BILBAO;4;21;U;1151;741;2;739;3;736;410;335;91;0;1;108;4;4;19;1;0;90;;1;;81;1
BIZKAIA;20;BILBAO;4;22;A;625;386;4;382;3;379;239;167;34;0;0;61;3;0;15;0;0;59;;1;;39;0
BIZKAIA;20;BILBAO;4;22;B;584;368;0;368;1;367;216;173;46;0;0;65;0;0;7;0;0;37;;1;;38;0
BIZKAIA;20;BILBAO;4;24;A;634;375;1;374;2;372;259;132;41;0;0;62;9;1;8;1;0;52;;4;;60;2
BIZKAIA;20;BILBAO;4;24;B;621;337;1;336;1;335;284;111;43;0;0;59;6;0;7;0;0;48;;2;;59;0
BIZKAIA;20;BILBAO;4;25;U;837;437;0;437;3;434;400;162;54;3;0;72;2;1;4;1;0;49;;4;;82;0
BIZKAIA;20;BILBAO;4;26;U;865;466;1;465;4;461;399;205;34;0;0;89;7;0;0;0;0;63;;2;;59;2
BIZKAIA;20;BILBAO;4;27;U;778;386;1;385;3;382;392;174;24;1;0;30;5;1;6;0;0;75;;4;;60;2
BIZKAIA;20;BILBAO;4;28;U;957;552;4;548;4;544;405;210;64;0;1;81;8;1;11;1;0;67;;6;;91;3
BIZKAIA;20;BILBAO;4;29;A;704;459;1;458;4;454;245;181;46;0;0;53;2;2;7;0;0;82;;1;;78;2
BIZKAIA;20;BILBAO;4;29;B;766;458;2;456;3;453;308;167;41;1;2;69;1;2;15;0;0;91;;3;;60;1
BIZKAIA;20;BILBAO;4;30;A;684;395;2;393;4;389;289;137;51;1;1;71;2;0;10;1;0;41;;3;;70;1
BIZKAIA;20;BILBAO;4;30;B;648;346;4;342;0;342;302;112;53;0;0;58;2;0;7;0;0;48;;2;;57;3
BIZKAIA;20;BILBAO;4;31;U;569;330;1;329;0;329;239;134;36;0;1;57;4;0;3;1;0;42;;0;;51;0
BIZKAIA;20;BILBAO;4;32;U;836;452;1;451;1;450;384;177;43;0;0;76;3;0;6;0;0;61;;1;;81;2
BIZKAIA;20;BILBAO;4;33;U;1115;559;1;558;4;554;556;197;66;0;3;111;7;2;9;0;1;53;;0;;105;0
BIZKAIA;20;BILBAO;4;35;U;688;412;1;411;0;411;276;153;28;0;0;50;5;1;5;0;0;77;;5;;86;1
BIZKAIA;20;BILBAO;4;36;U;1048;564;6;558;3;555;484;219;45;1;0;86;4;1;3;2;0;87;;4;;103;0
BIZKAIA;20;BILBAO;4;37;A;586;332;2;330;4;326;254;116;31;1;0;52;4;1;7;0;0;39;;5;;68;2
BIZKAIA;20;BILBAO;4;37;B;650;363;1;362;5;357;287;120;43;1;0;67;2;0;6;1;0;36;;0;;79;2
BIZKAIA;20;BILBAO;4;38;U;665;367;0;367;1;366;298;150;41;0;0;50;3;2;12;1;0;41;;1;;63;2
BIZKAIA;20;BILBAO;4;39;A;833;492;2;490;6;484;341;182;27;0;2;56;5;2;4;1;0;83;;3;;118;1
BIZKAIA;20;BILBAO;4;39;B;826;487;1;486;5;481;339;169;29;0;1;59;3;0;15;1;0;96;;6;;101;1
BIZKAIA;20;BILBAO;5;1;A;753;514;0;514;4;510;239;215;45;0;0;36;2;0;17;3;0;98;;1;;90;3
BIZKAIA;20;BILBAO;5;1;B;685;459;1;458;4;454;226;156;60;0;1;37;3;2;6;0;0;104;;3;;82;0
BIZKAIA;20;BILBAO;5;2;U;648;388;3;385;1;384;260;159;22;0;1;33;2;0;2;1;0;89;;1;;72;2
BIZKAIA;20;BILBAO;5;3;A;690;457;2;455;5;450;233;160;50;0;0;43;2;2;9;4;0;100;;2;;77;1
BIZKAIA;20;BILBAO;5;3;B;692;464;0;464;3;461;228;166;59;1;0;36;4;2;8;3;1;85;;5;;88;3
BIZKAIA;20;BILBAO;5;4;A;741;469;1;468;3;465;272;211;32;1;1;40;3;3;4;1;1;88;;3;;77;0
BIZKAIA;20;BILBAO;5;4;B;749;445;4;441;2;439;304;167;42;0;0;52;3;0;7;0;0;81;;4;;81;2
BIZKAIA;20;BILBAO;5;5;U;1034;722;3;719;2;717;312;241;56;1;3;66;4;2;11;0;3;185;;3;;141;1
BIZKAIA;20;BILBAO;5;6;U;940;597;0;597;4;593;343;185;21;0;0;44;6;0;11;1;0;188;;1;;135;1
BIZKAIA;20;BILBAO;5;7;U;785;500;1;499;4;495;285;133;19;0;0;41;12;1;6;0;0;165;;0;;118;0
BIZKAIA;20;BILBAO;5;8;A;636;408;2;406;2;404;228;124;20;1;1;24;2;0;3;0;1;158;;2;;65;3
BIZKAIA;20;BILBAO;5;8;B;555;346;4;342;2;340;209;101;19;0;1;21;2;0;3;0;0;106;;4;;82;1
BIZKAIA;20;BILBAO;5;9;A;791;521;2;519;4;515;270;189;40;0;0;46;5;1;3;3;0;136;;3;;87;2
BIZKAIA;20;BILBAO;5;9;B;816;527;4;523;2;521;289;154;34;0;0;54;4;3;7;2;0;155;;4;;104;0
BIZKAIA;20;BILBAO;5;10;U;837;524;5;519;1;518;313;192;45;1;0;41;3;2;7;1;1;119;;4;;100;2
BIZKAIA;20;BILBAO;5;11;U;819;476;3;473;1;472;343;181;39;0;1;52;4;2;3;0;0;115;;2;;70;3
BIZKAIA;20;BILBAO;5;12;U;1154;664;3;661;8;653;490;271;62;0;1;66;9;1;17;1;0;112;;4;;107;2
BIZKAIA;20;BILBAO;5;13;U;516;314;1;313;1;312;202;107;13;0;0;19;4;2;3;0;0;89;;0;;72;3
BIZKAIA;20;BILBAO;5;14;U;711;505;0;505;0;505;206;226;54;1;0;41;0;1;13;3;0;97;;3;;66;0
BIZKAIA;20;BILBAO;5;15;A;679;396;2;394;2;392;283;141;38;0;1;41;3;2;6;2;0;78;;0;;80;0
BIZKAIA;20;BILBAO;5;15;B;597;361;1;360;3;357;236;133;22;0;0;32;2;2;10;1;0;82;;2;;68;3
BIZKAIA;20;BILBAO;5;16;A;602;353;0;353;1;352;249;108;13;0;0;28;6;0;2;0;0;122;;1;;69;3
BIZKAIA;20;BILBAO;5;16;B;448;275;3;272;1;271;173;128;51;0;0;39;3;0;5;0;0;24;;1;;20;0
BIZKAIA;20;BILBAO;5;17;U;976;589;2;587;8;579;387;197;70;1;0;81;1;2;16;2;0;107;;0;;96;6
BIZKAIA;20;BILBAO;5;18;U;929;498;1;497;3;494;431;130;16;2;0;46;2;1;2;1;1;192;;1;;99;1
BIZKAIA;20;BILBAO;5;19;U;842;512;2;510;3;507;330;132;47;1;0;41;10;0;10;2;0;134;;2;;122;6
BIZKAIA;20;BILBAO;5;20;U;543;329;4;325;1;324;214;89;32;2;0;26;1;2;5;1;1;97;;1;;67;0
BIZKAIA;20;BILBAO;5;21;U;1069;526;0;526;3;523;543;169;34;1;1;44;7;1;7;2;1;149;;6;;99;2
BIZKAIA;20;BILBAO;5;22;U;892;450;1;449;3;446;442;118;29;0;1;48;4;0;2;2;0;135;;1;;104;2
BIZKAIA;20;BILBAO;5;24;A;671;355;0;355;3;352;316;140;37;3;2;46;3;0;10;0;0;63;;3;;42;3
BIZKAIA;20;BILBAO;5;24;B;650;320;2;318;0;318;330;121;32;0;0;43;2;1;11;0;0;40;;3;;63;2
BIZKAIA;20;BILBAO;5;25;A;731;371;1;370;0;370;360;149;21;2;0;50;6;0;6;3;0;72;;4;;56;1
BIZKAIA;20;BILBAO;5;25;B;629;333;0;333;0;333;296;112;18;0;0;54;4;0;10;0;0;58;;1;;71;5
BIZKAIA;20;BILBAO;5;26;U;680;302;2;300;4;296;378;90;28;1;0;33;2;0;1;0;0;65;;3;;73;0
BIZKAIA;20;BILBAO;5;28;U;788;446;0;446;3;443;342;199;51;0;1;54;6;0;9;2;0;57;;0;;62;2
BIZKAIA;20;BILBAO;5;29;U;1119;737;1;736;8;728;382;306;54;0;0;81;11;3;27;3;0;94;;7;;139;3
BIZKAIA;20;BILBAO;5;30;A;829;430;1;429;3;426;399;148;26;1;0;34;7;0;8;1;1;114;;4;;81;1
BIZKAIA;20;BILBAO;5;30;B;707;382;3;379;2;377;325;123;12;0;0;28;5;0;4;0;0;105;;4;;95;1
BIZKAIA;20;BILBAO;5;31;U;960;538;3;535;1;534;422;177;37;0;1;52;5;2;10;0;0;136;;2;;111;1
BIZKAIA;20;BILBAO;5;32;A;866;574;2;572;6;566;292;235;45;0;0;76;4;1;9;1;0;102;;3;;89;1
BIZKAIA;20;BILBAO;5;32;B;812;527;1;526;3;523;285;225;52;0;0;75;6;0;16;1;0;72;;6;;68;2
BIZKAIA;20;BILBAO;5;34;U;939;450;0;450;1;449;489;212;19;0;0;50;8;2;6;1;0;77;;5;;68;1
BIZKAIA;20;BILBAO;5;35;A;811;453;3;450;2;448;358;191;50;1;0;53;5;2;11;1;0;58;;2;;70;4
BIZKAIA;20;BILBAO;5;35;B;753;420;2;418;3;415;333;175;50;0;0;51;2;1;19;0;0;46;;3;;68;0
BIZKAIA;20;BILBAO;5;36;A;852;436;4;432;3;429;416;178;39;1;0;59;10;2;6;0;0;50;;6;;77;1
BIZKAIA;20;BILBAO;5;36;B;891;497;1;496;6;490;394;180;52;0;1;78;3;0;9;0;0;68;;6;;92;1
BIZKAIA;20;BILBAO;5;37;U;946;510;1;509;5;504;436;213;24;0;0;64;2;1;1;1;2;98;;3;;92;3
BIZKAIA;20;BILBAO;5;38;U;979;541;2;539;2;537;438;250;32;1;0;110;2;2;7;0;0;63;;2;;68;0
BIZKAIA;20;BILBAO;5;39;U;648;376;2;374;3;371;272;176;31;2;1;58;1;1;4;2;0;50;;2;;43;0
BIZKAIA;20;BILBAO;5;40;A;807;432;0;432;3;429;375;192;23;0;1;54;5;2;7;0;0;55;;6;;83;1
BIZKAIA;20;BILBAO;5;40;B;820;447;1;446;1;445;373;203;37;1;0;52;3;0;7;1;0;68;;3;;70;0
BIZKAIA;20;BILBAO;5;41;A;619;405;2;403;0;403;214;169;38;0;1;68;1;0;7;0;0;61;;3;;53;2
BIZKAIA;20;BILBAO;5;41;B;585;370;0;370;2;368;215;157;56;1;0;41;2;0;13;1;0;44;;4;;49;0
BIZKAIA;20;BILBAO;5;42;U;888;558;0;558;8;550;330;266;28;1;0;53;4;2;14;1;0;79;;2;;99;1
BIZKAIA;20;BILBAO;5;43;A;699;457;0;457;2;455;242;214;41;0;0;34;2;1;11;3;0;70;;4;;73;2
BIZKAIA;20;BILBAO;5;43;B;722;461;2;459;3;456;261;186;38;0;0;50;2;2;12;1;2;89;;6;;68;0
BIZKAIA;20;BILBAO;5;44;U;623;298;2;296;0;296;325;114;20;0;0;25;6;0;5;1;1;56;;1;;66;1
BIZKAIA;20;BILBAO;5;45;U;905;577;1;576;0;576;328;244;27;1;0;47;5;2;14;2;0;102;;4;;128;0
BIZKAIA;20;BILBAO;5;46;U;770;481;0;481;3;478;289;200;21;0;1;45;3;4;7;0;0;83;;3;;111;0
BIZKAIA;20;BILBAO;6;1;A;708;496;0;496;2;494;212;234;167;0;0;30;2;0;17;0;1;22;;1;;20;0
BIZKAIA;20;BILBAO;6;1;B;609;419;1;418;2;416;190;191;146;0;2;33;1;1;12;0;0;15;;2;;13;0
BIZKAIA;20;BILBAO;6;2;A;851;607;1;606;4;602;244;297;176;0;1;34;7;4;26;0;0;25;;0;;30;2
BIZKAIA;20;BILBAO;6;2;B;845;601;1;600;8;592;244;292;182;0;0;33;2;1;19;2;0;17;;1;;40;3
BIZKAIA;20;BILBAO;6;3;U;977;692;1;691;7;684;285;318;160;0;0;57;6;2;32;1;0;55;;1;;51;1
BIZKAIA;20;BILBAO;6;4;U;730;515;2;513;5;508;215;257;113;0;1;27;2;2;14;0;0;29;;1;;60;2
BIZKAIA;20;BILBAO;6;5;U;833;631;0;631;4;627;202;271;177;0;0;66;9;2;21;0;0;29;;0;;48;4
BIZKAIA;20;BILBAO;6;6;U;667;457;3;454;3;451;210;208;92;0;0;51;6;0;13;1;0;39;;0;;41;0
BIZKAIA;20;BILBAO;6;7;U;1127;794;5;789;8;781;333;377;258;0;0;34;2;0;33;2;1;34;;1;;38;1
BIZKAIA;20;BILBAO;6;8;U;616;469;0;469;1;468;147;202;142;0;0;39;5;0;13;1;0;32;;5;;29;0
BIZKAIA;20;BILBAO;6;9;A;657;468;2;466;2;464;189;185;117;0;0;48;5;0;25;0;0;45;;2;;36;1
BIZKAIA;20;BILBAO;6;9;B;584;405;0;405;2;403;179;190;99;0;0;48;0;1;11;0;0;30;;0;;24;0
BIZKAIA;20;BILBAO;6;10;A;690;488;0;488;1;487;202;222;100;1;0;45;4;1;9;1;0;46;;0;;56;2
BIZKAIA;20;BILBAO;6;10;B;642;433;0;433;4;429;209;194;84;0;0;37;6;1;17;0;0;47;;3;;39;1
BIZKAIA;20;BILBAO;6;11;U;677;471;3;468;0;468;206;223;126;0;0;25;2;1;26;3;0;29;;1;;32;0
BIZKAIA;20;BILBAO;6;12;U;725;512;0;512;1;511;213;237;139;0;0;52;1;2;19;1;1;26;;1;;32;0
BIZKAIA;20;BILBAO;6;13;A;876;585;2;583;6;577;291;270;125;0;0;44;5;3;27;1;0;54;;2;;45;1
BIZKAIA;20;BILBAO;6;13;B;787;528;3;525;3;522;259;226;125;0;0;44;4;1;19;4;0;42;;3;;52;2
BIZKAIA;20;BILBAO;6;15;A;657;463;0;463;5;458;194;239;122;0;1;21;5;0;11;1;0;27;;1;;29;1
BIZKAIA;20;BILBAO;6;15;B;632;429;0;429;2;427;203;220;104;0;0;32;1;1;18;0;0;27;;0;;24;0
BIZKAIA;20;BILBAO;6;16;U;901;688;1;687;3;684;213;279;302;0;0;29;3;0;18;0;0;36;;0;;17;0
BIZKAIA;20;BILBAO;6;17;A;675;476;1;475;1;474;199;253;138;0;0;27;1;0;20;1;0;19;;1;;14;0
BIZKAIA;20;BILBAO;6;17;B;647;452;1;451;5;446;195;197;143;0;0;31;1;0;21;1;0;19;;0;;31;2
BIZKAIA;20;BILBAO;6;18;U;625;459;2;457;0;457;166;182;178;0;0;33;0;0;18;1;0;26;;2;;16;1
BIZKAIA;20;BILBAO;6;19;U;549;377;2;375;4;371;172;176;104;0;1;26;5;2;17;0;1;20;;0;;19;0
BIZKAIA;20;BILBAO;6;20;U;1016;728;1;727;2;725;288;312;251;0;0;48;1;0;32;1;2;43;;2;;31;2
BIZKAIA;20;BILBAO;6;21;U;999;704;3;701;4;697;295;309;190;0;0;67;11;3;18;1;0;49;;2;;46;1
BIZKAIA;20;BILBAO;6;22;U;704;493;1;492;2;490;211;289;81;0;1;26;5;2;23;0;0;32;;0;;29;2
BIZKAIA;20;BILBAO;6;23;U;634;453;1;452;2;450;181;238;79;0;0;31;5;3;14;1;0;45;;3;;30;1
BIZKAIA;20;BILBAO;6;24;U;687;456;1;455;3;452;231;207;102;1;0;44;2;0;20;2;0;42;;3;;29;0
BIZKAIA;20;BILBAO;6;25;U;868;594;1;593;5;588;274;307;107;0;0;51;5;2;19;3;1;44;;1;;46;2
BIZKAIA;20;BILBAO;6;26;U;1012;708;1;707;2;705;304;320;201;1;0;47;3;2;21;1;0;49;;2;;58;0
BIZKAIA;20;BILBAO;6;27;U;531;390;0;390;3;387;141;204;108;1;0;20;6;2;16;1;0;8;;2;;19;0
BIZKAIA;20;BILBAO;6;28;U;727;495;0;495;2;493;232;221;128;0;0;40;4;0;19;0;1;33;;2;;44;1
BIZKAIA;20;BILBAO;6;29;U;1023;669;3;666;4;662;354;299;143;0;1;48;5;3;20;1;1;62;;3;;73;3
BIZKAIA;20;BILBAO;6;30;A;611;349;1;348;0;348;262;138;43;2;0;43;4;0;6;4;0;37;;4;;61;6
BIZKAIA;20;BILBAO;6;30;B;612;355;1;354;7;347;257;133;64;0;0;41;2;0;16;0;0;33;;4;;54;0
BIZKAIA;20;BILBAO;6;31;U;809;562;0;562;2;560;247;297;129;0;0;46;2;0;24;0;0;34;;2;;24;2
BIZKAIA;20;BILBAO;6;32;U;540;385;3;382;0;382;155;197;87;1;0;26;3;0;9;0;0;21;;2;;35;1
BIZKAIA;20;BILBAO;6;33;U;789;528;0;528;4;524;261;281;102;0;1;40;3;0;23;0;0;35;;1;;38;0
BIZKAIA;20;BILBAO;6;34;U;715;485;3;482;8;474;230;248;59;0;1;46;6;2;13;0;0;34;;3;;62;0
BIZKAIA;20;BILBAO;6;35;U;992;663;3;660;4;656;329;298;133;0;0;57;3;2;26;0;0;64;;1;;68;4
BIZKAIA;20;BILBAO;6;36;U;903;566;5;561;4;557;337;260;139;0;0;48;7;0;15;0;0;35;;3;;49;1
BIZKAIA;20;BILBAO;6;37;U;855;594;2;592;5;587;261;283;122;0;0;67;6;3;15;0;0;37;;3;;51;0
BIZKAIA;20;BILBAO;6;38;U;785;528;5;523;5;518;257;287;121;0;0;42;4;0;12;1;0;19;;0;;32;0
BIZKAIA;20;BILBAO;6;39;U;1160;807;7;800;5;795;353;387;186;0;0;78;4;3;31;0;1;52;;2;;49;2
BIZKAIA;20;BILBAO;6;41;A;666;462;0;462;3;459;204;222;87;1;0;36;4;0;18;3;0;45;;2;;40;1
BIZKAIA;20;BILBAO;6;41;B;674;433;0;433;4;429;241;201;75;2;0;49;0;2;13;0;0;47;;4;;36;0
BIZKAIA;20;BILBAO;6;42;U;882;568;2;566;3;563;314;236;90;0;0;53;13;2;19;0;0;57;;4;;89;0
BIZKAIA;20;BILBAO;6;43;U;806;513;0;513;5;508;293;221;73;0;0;63;3;1;10;0;0;55;;5;;73;4
BIZKAIA;20;BILBAO;6;44;U;750;494;2;492;4;488;256;218;70;0;0;56;3;0;8;1;0;63;;1;;66;2
BIZKAIA;20;BILBAO;6;45;U;886;588;1;587;1;586;298;287;137;0;1;36;3;2;15;1;0;59;;2;;43;0
BIZKAIA;20;BILBAO;6;46;A;600;400;0;400;4;396;200;200;71;0;0;33;3;1;12;1;0;41;;1;;30;3
BIZKAIA;20;BILBAO;6;46;B;683;443;0;443;2;441;240;219;85;0;1;41;2;0;7;0;1;44;;1;;40;0
BIZKAIA;20;BILBAO;7;1;U;817;548;2;546;6;540;269;247;135;0;0;54;2;1;8;2;0;47;;2;;41;1
BIZKAIA;20;BILBAO;7;2;U;597;405;2;403;6;397;192;174;76;1;0;56;3;1;3;13;1;29;;4;;35;1
BIZKAIA;20;BILBAO;7;3;U;921;572;1;571;2;569;349;245;118;0;0;78;3;1;8;3;0;49;;2;;61;1
BIZKAIA;20;BILBAO;7;4;U;656;426;2;424;7;417;230;189;66;0;0;44;2;1;6;2;0;50;;0;;54;3
BIZKAIA;20;BILBAO;7;5;U;728;457;1;456;7;449;271;187;92;2;0;64;6;2;10;0;1;34;;3;;48;0
BIZKAIA;20;BILBAO;7;6;A;579;354;0;354;2;352;225;149;57;0;0;28;5;1;4;1;0;47;;0;;60;0
BIZKAIA;20;BILBAO;7;6;B;590;376;0;376;1;375;214;162;59;1;0;47;6;1;12;0;0;31;;1;;55;0
BIZKAIA;20;BILBAO;7;7;U;528;357;0;357;3;354;171;168;71;0;0;27;0;1;15;1;0;36;;1;;34;0
BIZKAIA;20;BILBAO;7;8;U;1064;666;1;665;5;660;398;306;115;0;1;76;6;1;20;0;0;58;;1;;75;1
BIZKAIA;20;BILBAO;7;10;U;1160;708;3;705;4;701;452;293;110;1;0;75;8;1;17;3;0;80;;0;;112;1
BIZKAIA;20;BILBAO;7;12;U;884;618;2;616;1;615;266;265;180;0;0;60;5;1;23;1;1;29;;0;;48;2
BIZKAIA;20;BILBAO;7;13;A;842;565;1;564;8;556;277;258;80;0;0;66;6;3;17;0;0;47;;3;;73;3
BIZKAIA;20;BILBAO;7;13;B;876;563;1;562;8;554;313;256;78;1;1;63;2;0;18;5;0;52;;3;;73;2
BIZKAIA;20;BILBAO;7;14;U;556;309;0;309;5;304;247;145;38;0;0;24;0;0;6;1;0;48;;1;;41;0
BIZKAIA;20;BILBAO;7;15;U;586;326;0;326;0;326;260;128;36;0;2;49;0;3;4;0;0;45;;3;;54;2
BIZKAIA;20;BILBAO;7;16;U;948;617;2;615;7;608;331;259;97;0;0;76;8;0;22;1;1;56;;1;;85;2
BIZKAIA;20;BILBAO;7;17;A;687;394;0;394;3;391;293;164;37;0;0;48;5;0;15;0;0;56;;4;;62;0
BIZKAIA;20;BILBAO;7;17;B;706;390;2;388;0;388;316;156;34;0;0;55;9;0;6;2;0;56;;2;;67;1
BIZKAIA;20;BILBAO;7;19;U;1081;609;5;604;2;602;472;256;68;1;1;74;8;0;9;0;1;72;;2;;109;1
BIZKAIA;20;BILBAO;7;21;U;1064;615;4;611;1;610;449;221;79;0;0;106;6;0;16;0;0;68;;6;;103;5
BIZKAIA;20;BILBAO;7;22;A;672;380;1;379;2;377;292;124;34;1;0;57;6;1;15;1;0;65;;6;;66;1
BIZKAIA;20;BILBAO;7;22;B;675;380;2;378;4;374;295;148;27;0;1;50;7;0;6;1;0;39;;7;;87;1
BIZKAIA;20;BILBAO;7;23;U;1153;581;0;581;1;580;572;186;52;1;0;86;7;2;12;2;0;107;;3;;119;3
BIZKAIA;20;BILBAO;7;24;U;816;458;4;454;3;451;358;182;44;0;0;54;5;1;14;2;1;64;;4;;78;2
BIZKAIA;20;BILBAO;7;26;A;613;373;0;373;0;373;240;150;47;0;0;62;3;1;7;2;1;38;;1;;61;0
BIZKAIA;20;BILBAO;7;26;B;594;360;0;360;3;357;234;164;38;0;0;66;2;1;9;0;0;24;;1;;52;0
BIZKAIA;20;BILBAO;7;27;A;617;355;0;355;2;353;262;142;35;1;0;58;0;1;10;3;1;53;;1;;48;0
BIZKAIA;20;BILBAO;7;27;B;640;358;0;358;2;356;282;133;37;1;0;73;2;0;7;0;0;43;;3;;57;0
BIZKAIA;20;BILBAO;7;28;U;753;350;0;350;1;349;403;120;46;0;2;62;5;0;10;1;0;41;;0;;61;1
BIZKAIA;20;BILBAO;7;29;U;908;470;1;469;9;460;438;185;71;0;0;62;5;1;6;0;0;61;;4;;63;2
BIZKAIA;20;BILBAO;7;30;A;611;346;1;345;1;344;265;145;35;0;2;45;2;1;1;0;0;53;;5;;53;2
BIZKAIA;20;BILBAO;7;30;B;616;332;1;331;1;330;284;125;42;0;1;35;8;0;5;0;0;45;;4;;64;1
BIZKAIA;20;BILBAO;7;31;U;529;292;3;289;2;287;237;89;22;0;0;59;3;1;6;0;0;51;;1;;55;0
BIZKAIA;20;BILBAO;7;32;U;1073;583;3;580;8;572;490;238;98;2;0;86;2;1;14;0;0;46;;6;;77;2
BIZKAIA;20;BILBAO;7;33;U;761;417;2;415;4;411;344;143;42;0;0;80;4;1;8;1;0;62;;3;;65;2
BIZKAIA;20;BILBAO;7;34;U;717;368;1;367;3;364;349;126;31;0;1;38;5;1;6;1;0;71;;3;;80;1
BIZKAIA;20;BILBAO;7;35;A;756;422;1;421;4;417;334;136;51;0;1;63;4;1;4;0;1;58;;5;;93;0
BIZKAIA;20;BILBAO;7;35;B;769;423;1;422;1;421;346;147;56;0;0;79;4;2;9;1;0;43;;5;;73;2
BIZKAIA;20;BILBAO;7;36;U;601;285;0;285;0;285;316;127;28;0;0;58;1;1;3;1;0;36;;0;;29;1
BIZKAIA;20;BILBAO;7;37;U;607;280;7;273;2;271;327;106;13;0;0;49;2;1;3;2;0;34;;5;;54;2
BIZKAIA;20;BILBAO;7;38;A;717;365;1;364;1;363;352;134;26;2;1;60;2;0;5;0;1;59;;1;;69;3
BIZKAIA;20;BILBAO;7;38;B;738;409;4;405;1;404;329;138;40;0;0;62;3;0;12;0;0;50;;9;;90;0
BIZKAIA;20;BILBAO;7;39;U;561;267;0;267;1;266;294;96;19;0;2;59;2;0;2;1;0;35;;2;;47;1
BIZKAIA;20;BILBAO;7;40;U;802;378;1;377;1;376;424;158;41;1;1;70;5;1;8;0;0;25;;8;;56;2
BIZKAIA;20;BILBAO;7;41;A;581;330;0;330;4;326;251;143;36;0;1;36;5;2;10;0;0;55;;0;;34;4
BIZKAIA;20;BILBAO;7;41;B;617;318;0;318;2;316;299;140;30;0;0;34;0;2;11;3;0;38;;1;;54;3
BIZKAIA;20;BILBAO;7;42;U;1074;679;2;677;5;672;395;266;96;0;0;90;5;1;36;3;0;59;;4;;112;0
BIZKAIA;20;BILBAO;7;43;U;1120;654;0;654;3;651;466;264;81;0;0;98;8;1;25;1;0;62;;1;;108;2
BIZKAIA;20;BILBAO;8;1;U;1024;512;2;510;3;507;512;201;39;0;0;70;7;2;4;0;0;83;;6;;94;1
BIZKAIA;20;BILBAO;8;2;A;609;340;0;340;2;338;269;152;32;0;0;55;3;0;1;0;0;38;;3;;53;1
BIZKAIA;20;BILBAO;8;2;B;687;408;2;406;2;404;279;170;41;1;1;75;3;2;3;0;0;54;;4;;49;1
BIZKAIA;20;BILBAO;8;3;U;1061;575;1;574;2;572;486;220;51;0;0;98;6;1;18;1;0;81;;2;;94;0
BIZKAIA;20;BILBAO;8;4;U;1080;575;4;571;4;567;505;195;73;1;1;116;2;2;27;0;0;62;;3;;84;1
BIZKAIA;20;BILBAO;8;5;U;982;536;0;536;3;533;446;197;43;0;1;103;11;0;6;0;0;74;;2;;96;0
BIZKAIA;20;BILBAO;8;6;U;758;402;0;402;3;399;356;159;23;0;1;69;2;2;12;2;0;43;;5;;80;1
BIZKAIA;20;BILBAO;8;7;A;566;273;1;272;1;271;293;101;26;0;0;41;3;1;11;0;0;30;;3;;55;0
BIZKAIA;20;BILBAO;8;7;B;610;298;1;297;1;296;312;100;37;0;0;53;2;1;9;0;0;39;;0;;51;4
BIZKAIA;20;BILBAO;8;8;A;692;360;0;360;1;359;332;162;20;0;0;58;1;1;4;1;0;43;;4;;65;0
BIZKAIA;20;BILBAO;8;8;B;752;405;0;405;1;404;347;166;34;1;0;59;1;2;5;0;0;75;;6;;54;1
BIZKAIA;20;BILBAO;8;9;U;535;261;0;261;1;260;274;126;30;1;2;31;5;1;3;1;1;35;;2;;22;0
BIZKAIA;20;BILBAO;8;10;U;945;504;2;502;3;499;441;228;55;0;0;65;2;3;7;3;1;60;;6;;69;0
BIZKAIA;20;BILBAO;8;12;U;975;574;2;572;4;568;401;245;19;0;2;55;4;0;7;0;0;126;;1;;106;3
BIZKAIA;20;BILBAO;8;13;A;533;260;1;259;1;258;273;83;62;0;0;28;3;2;12;0;1;28;;0;;39;0
BIZKAIA;20;BILBAO;8;13;B;711;344;3;341;2;339;367;126;64;0;0;47;4;0;8;0;1;36;;1;;51;1
BIZKAIA;20;BILBAO;8;14;U;999;603;6;597;2;595;396;233;65;0;0;102;13;2;25;0;0;56;;9;;89;1
BIZKAIA;20;BILBAO;8;15;A;744;477;2;475;5;470;267;228;43;0;0;65;5;1;21;1;0;36;;1;;66;3
BIZKAIA;20;BILBAO;8;15;B;795;502;0;502;5;497;293;202;62;1;0;72;6;2;15;3;0;54;;2;;77;1
BIZKAIA;20;BILBAO;8;16;A;749;479;1;478;1;477;270;187;61;1;0;44;6;0;24;3;0;58;;4;;87;2
BIZKAIA;20;BILBAO;8;16;B;755;483;3;480;5;475;272;209;62;0;0;39;4;0;9;1;1;58;;3;;86;3
BIZKAIA;20;BILBAO;8;18;A;626;434;6;428;0;428;192;208;94;0;0;36;3;0;20;3;0;33;;0;;29;2
BIZKAIA;20;BILBAO;8;18;B;690;478;3;475;5;470;212;228;103;0;0;37;3;0;17;2;0;36;;2;;40;2
BIZKAIA;20;BILBAO;8;19;A;631;422;1;421;6;415;209;186;76;0;0;49;8;1;13;1;0;39;;1;;40;1
BIZKAIA;20;BILBAO;8;19;B;634;454;2;452;2;450;180;221;70;0;0;42;4;2;8;0;0;34;;5;;62;2
BIZKAIA;20;BILBAO;8;20;A;585;369;2;367;2;365;216;174;67;0;0;39;1;0;10;0;0;35;;1;;37;1
BIZKAIA;20;BILBAO;8;20;B;646;408;2;406;1;405;238;188;81;1;0;46;3;1;13;1;1;25;;1;;44;0
BIZKAIA;20;BILBAO;8;21;U;890;538;3;535;0;535;352;263;63;1;2;68;5;1;22;1;0;44;;4;;60;1
BIZKAIA;20;BILBAO;8;22;A;724;477;0;477;2;475;247;211;108;0;1;56;3;1;6;0;0;44;;1;;44;0
BIZKAIA;20;BILBAO;8;22;B;732;489;1;488;2;486;243;227;98;0;2;61;4;1;7;1;0;38;;1;;46;0
BIZKAIA;20;BILBAO;8;23;U;934;551;0;551;0;551;383;229;95;0;0;88;6;0;5;1;0;51;;2;;73;1
BIZKAIA;20;BILBAO;8;24;A;821;529;1;528;2;526;292;230;90;0;0;82;3;0;15;1;0;50;;2;;52;1
BIZKAIA;20;BILBAO;8;24;B;861;523;1;522;3;519;338;204;99;2;0;71;7;1;23;2;1;49;;6;;53;1
BIZKAIA;20;BILBAO;8;25;U;944;538;2;536;6;530;406;257;42;0;0;61;3;1;22;2;0;39;;3;;98;2
BIZKAIA;21;BUSTURIA;1;1;U;641;460;3;457;1;456;181;252;8;0;1;10;0;0;4;0;0;134;;2;;45;0
BIZKAIA;21;BUSTURIA;1;2;U;696;440;1;439;2;437;256;222;10;0;1;26;1;0;6;0;0;131;;3;;36;1
BIZKAIA;22;KARRANTZA HARANA/VALLE DE CARRANZA;1;1;A;641;421;2;419;1;418;220;250;17;0;0;19;3;2;5;0;0;63;;4;;55;0
BIZKAIA;22;KARRANTZA HARANA/VALLE DE CARRANZA;1;1;B;752;481;2;479;3;476;271;299;15;0;0;16;2;0;6;0;0;68;;1;;69;0
BIZKAIA;22;KARRANTZA HARANA/VALLE DE CARRANZA;1;2;U;923;539;4;535;3;532;384;326;16;0;0;43;1;2;3;0;0;84;;1;;54;2
BIZKAIA;23;ARTEA;1;1;U;608;481;2;479;3;476;127;234;13;0;0;5;2;0;2;1;0;186;;1;;32;0
BIZKAIA;24;ZEANURI;1;1;A;577;460;1;459;2;457;117;239;5;0;0;2;3;1;3;0;0;184;;3;;17;0
BIZKAIA;24;ZEANURI;1;1;B;418;346;0;346;3;343;72;182;3;0;0;3;0;0;2;0;0;125;;0;;27;1
BIZKAIA;25;ZEBERIO;1;1;A;359;256;1;255;2;253;103;107;3;0;0;1;2;0;0;0;1;115;;0;;24;0
BIZKAIA;25;ZEBERIO;1;1;B;520;389;1;388;1;387;131;216;2;0;0;3;3;2;0;0;0;128;;0;;33;0
BIZKAIA;26;DIMA;1;1;U;1144;871;5;866;1;865;273;327;6;1;0;5;3;0;2;0;0;463;;2;;56;0
BIZKAIA;27;DURANGO;1;1;U;650;411;3;408;5;403;239;141;29;1;0;24;2;0;6;0;0;136;;1;;62;1
BIZKAIA;27;DURANGO;1;2;U;909;598;0;598;5;593;311;265;42;0;1;32;7;2;15;1;0;154;;2;;72;0
BIZKAIA;27;DURANGO;1;3;U;748;499;6;493;4;489;249;220;45;1;0;44;7;1;3;0;0;106;;1;;60;1
BIZKAIA;27;DURANGO;1;4;U;629;401;0;401;3;398;228;178;40;0;1;31;3;0;2;1;0;74;;0;;67;1
BIZKAIA;27;DURANGO;2;1;U;718;437;3;434;2;432;281;168;38;0;0;30;3;0;2;0;1;126;;6;;58;0
BIZKAIA;27;DURANGO;2;2;U;884;546;1;545;3;542;338;211;33;1;1;72;2;0;6;1;0;145;;7;;61;2
BIZKAIA;27;DURANGO;2;3;U;727;467;1;466;4;462;260;238;37;1;0;31;2;0;4;1;0;108;;2;;37;1
BIZKAIA;27;DURANGO;3;1;A;870;582;4;578;2;576;288;239;29;0;0;33;3;1;9;0;0;196;;4;;62;0
BIZKAIA;27;DURANGO;3;1;B;750;485;1;484;0;484;265;218;25;0;0;30;2;0;7;2;0;137;;3;;60;0
BIZKAIA;27;DURANGO;3;2;A;605;358;0;358;3;355;247;114;19;0;0;37;3;0;3;3;0;96;;5;;70;5
BIZKAIA;27;DURANGO;3;2;B;550;296;2;294;2;292;254;85;21;0;0;40;3;0;11;0;0;66;;3;;62;1
BIZKAIA;27;DURANGO;4;1;A;873;564;3;561;1;560;309;235;29;0;0;50;5;1;14;3;1;127;;2;;93;0
BIZKAIA;27;DURANGO;4;1;B;674;413;2;411;6;405;261;160;30;1;0;45;2;0;8;0;0;85;;6;;68;0
BIZKAIA;27;DURANGO;4;2;A;662;458;1;457;0;457;204;231;35;0;0;30;1;1;3;2;0;102;;7;;45;0
BIZKAIA;27;DURANGO;4;2;B;618;409;0;409;1;408;209;166;36;0;0;30;0;1;10;0;0;103;;3;;59;0
BIZKAIA;27;DURANGO;4;3;A;788;516;2;514;1;513;272;223;53;0;2;57;6;0;7;1;0;125;;1;;37;1
BIZKAIA;27;DURANGO;4;3;B;605;375;1;374;2;372;230;155;42;0;0;63;0;0;6;0;0;65;;1;;39;1
BIZKAIA;27;DURANGO;4;4;A;739;474;4;470;3;467;265;216;28;0;0;39;2;2;4;1;0;110;;3;;61;1
BIZKAIA;27;DURANGO;4;4;B;627;379;4;375;3;372;248;154;31;0;0;33;1;1;3;2;1;73;;3;;70;0
BIZKAIA;27;DURANGO;4;5;A;802;554;0;554;6;548;248;260;29;1;0;37;3;4;12;2;0;124;;4;;71;1
BIZKAIA;27;DURANGO;4;5;B;743;517;1;516;4;512;226;229;35;0;1;61;3;0;11;0;0;108;;2;;61;1
BIZKAIA;27;DURANGO;4;6;A;550;375;3;372;1;371;175;157;30;0;0;27;1;0;3;0;0;115;;4;;33;1
BIZKAIA;27;DURANGO;4;6;B;483;321;11;310;1;309;162;128;25;0;0;31;3;1;3;0;0;73;;4;;41;0
BIZKAIA;27;DURANGO;4;7;U;743;480;2;478;6;472;263;225;31;0;0;38;1;1;9;0;1;113;;2;;51;0
BIZKAIA;27;DURANGO;5;1;U;617;422;1;421;2;419;195;210;70;0;0;17;1;2;8;1;0;84;;0;;26;0
BIZKAIA;27;DURANGO;5;2;A;729;464;3;461;0;461;265;174;25;0;0;35;3;0;6;0;0;153;;3;;61;1
BIZKAIA;27;DURANGO;5;2;B;623;404;1;403;5;398;219;138;32;0;0;48;2;1;2;0;0;103;;4;;67;1
BIZKAIA;27;DURANGO;5;2;C;610;361;2;359;0;359;249;128;22;0;0;33;2;0;9;2;0;102;;1;;59;1
BIZKAIA;27;DURANGO;5;3;A;899;599;4;595;1;594;300;228;22;0;0;59;3;0;11;2;0;195;;7;;67;0
BIZKAIA;27;DURANGO;5;3;B;716;472;3;469;0;469;244;165;25;0;0;53;4;0;11;1;0;134;;1;;74;1
BIZKAIA;27;DURANGO;5;4;A;599;430;1;429;2;427;169;229;28;0;0;18;2;0;6;0;0;100;;2;;42;0
BIZKAIA;27;DURANGO;5;4;B;456;323;2;321;3;318;133;162;29;0;0;13;1;0;4;0;0;76;;1;;32;0
BIZKAIA;28;EA;1;1;U;715;562;0;562;0;562;153;251;4;0;0;1;2;0;0;1;1;275;;1;;26;0
BIZKAIA;29;ETXEBARRI;1;1;A;600;402;3;399;7;392;198;179;22;0;0;39;4;0;14;1;0;53;;7;;72;1
BIZKAIA;29;ETXEBARRI;1;1;B;664;424;2;422;5;417;240;165;36;0;0;68;2;0;12;2;1;53;;9;;69;0
BIZKAIA;29;ETXEBARRI;1;2;A;774;453;0;453;3;450;321;181;39;1;0;76;5;0;21;0;0;35;;3;;87;2
BIZKAIA;29;ETXEBARRI;1;2;B;877;514;0;514;3;511;363;186;44;1;0;96;12;0;14;1;1;44;;2;;108;2
BIZKAIA;29;ETXEBARRI;1;3;U;862;433;2;431;5;426;429;137;42;0;0;100;7;1;10;1;5;24;;7;;89;3
BIZKAIA;29;ETXEBARRI;1;4;U;790;370;0;370;1;369;420;138;25;0;0;89;7;4;4;0;1;22;;0;;79;0
BIZKAIA;29;ETXEBARRI;1;5;A;707;481;2;479;2;477;226;230;29;0;0;45;11;1;9;1;0;65;;2;;82;2
BIZKAIA;29;ETXEBARRI;1;5;B;718;468;2;466;3;463;250;198;42;1;0;59;4;1;12;2;1;55;;1;;84;3
BIZKAIA;29;ETXEBARRI;1;6;A;567;310;2;308;4;304;257;92;29;1;1;44;3;1;8;0;0;36;;8;;78;3
BIZKAIA;29;ETXEBARRI;1;6;B;600;352;2;350;3;347;248;116;27;0;0;65;0;1;13;2;0;35;;3;;84;1
BIZKAIA;29;ETXEBARRI;1;7;A;579;374;0;374;6;368;205;137;30;0;0;40;5;2;5;1;0;55;;4;;87;2
BIZKAIA;29;ETXEBARRI;1;7;B;620;405;3;402;4;398;215;149;23;0;0;42;4;1;12;1;0;62;;4;;96;4
BIZKAIA;30;ETXEBARRIA;1;1;U;606;480;0;480;2;478;126;262;5;0;0;3;0;0;1;0;0;178;;2;;27;0
BIZKAIA;31;ELANTXOBE;1;1;U;327;248;1;247;0;247;79;147;1;0;0;0;1;0;2;0;0;90;;0;;5;1
BIZKAIA;32;ELORRIO;1;1;A;856;581;2;579;2;577;275;218;28;0;0;38;0;0;4;0;0;227;;1;;61;0
BIZKAIA;32;ELORRIO;1;1;B;594;377;2;375;2;373;217;147;24;0;0;31;0;2;5;1;0;132;;1;;30;0
BIZKAIA;32;ELORRIO;1;2;A;769;540;0;540;1;539;229;188;40;0;0;41;2;3;4;0;1;208;;2;;50;0
BIZKAIA;32;ELORRIO;1;2;B;593;399;0;399;1;398;194;141;29;0;1;43;2;3;3;1;0;133;;0;;42;0
BIZKAIA;32;ELORRIO;1;3;A;977;670;1;669;3;666;307;259;30;0;0;45;2;2;6;3;0;261;;0;;58;0
BIZKAIA;32;ELORRIO;1;3;B;731;496;1;495;5;490;235;182;27;0;0;25;2;1;6;1;0;190;;0;;56;0
BIZKAIA;32;ELORRIO;1;4;U;633;445;3;442;2;440;188;163;22;0;0;13;2;0;1;1;0;194;;0;;44;0
BIZKAIA;32;ELORRIO;1;5;U;588;400;1;399;1;398;188;162;28;1;0;16;2;2;5;0;0;151;;1;;30;0
BIZKAIA;33;EREÑO;1;1;U;218;160;1;159;0;159;58;79;1;0;0;1;0;0;1;0;0;59;;1;;17;0
BIZKAIA;34;ERMUA;1;1;A;475;281;1;280;3;277;194;73;33;0;1;59;0;0;4;3;1;50;;1;;52;0
BIZKAIA;34;ERMUA;1;1;B;481;287;0;287;3;284;194;75;40;0;0;59;3;0;2;0;0;47;;3;;54;1
BIZKAIA;34;ERMUA;1;2;U;859;474;2;472;6;466;385;133;67;0;5;125;3;0;16;1;0;31;;4;;80;1
BIZKAIA;34;ERMUA;1;3;A;655;368;2;366;1;365;287;102;66;1;1;94;2;0;11;0;0;22;;2;;61;3
BIZKAIA;34;ERMUA;1;3;B;642;346;1;345;0;345;296;77;62;0;1;114;4;0;6;0;1;16;;4;;57;3
BIZKAIA;34;ERMUA;1;4;A;745;451;0;451;3;448;294;136;40;0;2;87;3;0;15;0;0;73;;8;;82;2
BIZKAIA;34;ERMUA;1;4;B;671;427;1;426;3;423;244;130;45;0;0;75;3;1;13;1;0;75;;4;;75;1
BIZKAIA;34;ERMUA;1;5;U;800;476;2;474;2;472;324;127;67;0;0;86;5;1;9;1;2;85;;4;;85;0
BIZKAIA;34;ERMUA;1;6;A;638;342;0;342;4;338;296;67;50;1;0;90;5;0;9;1;0;46;;0;;66;3
BIZKAIA;34;ERMUA;1;6;B;564;285;3;282;2;280;279;63;48;0;0;56;3;2;9;1;1;36;;5;;54;2
BIZKAIA;34;ERMUA;1;7;A;612;351;1;350;4;346;261;66;42;0;0;88;1;0;14;1;0;43;;3;;86;2
BIZKAIA;34;ERMUA;1;7;B;597;353;0;353;2;351;244;102;44;0;0;90;5;1;11;0;0;34;;1;;63;0
BIZKAIA;34;ERMUA;1;8;A;790;513;2;511;2;509;277;146;81;0;0;101;5;0;14;1;1;80;;9;;68;3
BIZKAIA;34;ERMUA;1;8;B;799;524;6;518;0;518;275;150;79;0;3;120;4;0;17;2;0;56;;10;;74;3
BIZKAIA;34;ERMUA;1;9;A;612;324;2;322;1;321;288;89;40;4;0;97;3;0;5;1;0;27;;1;;54;0
BIZKAIA;34;ERMUA;1;9;B;592;348;5;343;1;342;244;90;48;1;0;99;2;1;6;0;0;28;;4;;61;2
BIZKAIA;34;ERMUA;1;10;A;531;325;1;324;0;324;206;111;46;1;0;50;1;5;8;0;1;51;;2;;48;0
BIZKAIA;34;ERMUA;1;10;B;497;276;0;276;1;275;221;72;34;0;0;66;2;0;7;0;0;46;;2;;45;1
BIZKAIA;34;ERMUA;1;11;A;672;417;2;415;5;410;255;108;46;0;0;101;4;1;17;1;1;64;;5;;62;0
BIZKAIA;34;ERMUA;1;11;B;599;356;1;355;2;353;243;107;31;0;0;84;1;2;12;1;0;42;;2;;71;0
BIZKAIA;35;FRUIZ;1;1;U;415;311;0;311;1;310;104;173;3;0;0;2;3;0;2;0;0;104;;0;;21;2
BIZKAIA;36;GALDAKAO;1;1;U;810;522;4;518;3;515;288;220;49;0;0;53;4;1;7;0;1;101;;3;;76;0
BIZKAIA;36;GALDAKAO;1;2;U;746;474;2;472;4;468;272;222;40;0;1;47;1;0;6;2;1;79;;0;;69;0
BIZKAIA;36;GALDAKAO;1;3;U;923;532;1;531;7;524;391;212;20;0;0;65;12;0;13;3;0;75;;3;;119;2
BIZKAIA;36;GALDAKAO;1;4;A;612;371;1;370;4;366;241;147;20;0;0;44;3;0;5;0;0;75;;0;;71;1
BIZKAIA;36;GALDAKAO;1;4;B;605;326;0;326;3;323;279;141;18;0;1;40;2;1;8;1;0;47;;2;;61;1
BIZKAIA;36;GALDAKAO;1;5;A;540;280;0;280;1;279;260;115;9;1;0;17;1;0;7;0;0;51;;3;;72;3
BIZKAIA;36;GALDAKAO;1;5;B;410;235;0;235;1;234;175;98;15;2;0;24;8;1;3;0;0;39;;3;;41;0
BIZKAIA;36;GALDAKAO;1;6;A;844;530;0;530;5;525;314;207;25;0;1;86;2;0;7;0;0;81;;2;;111;3
BIZKAIA;36;GALDAKAO;1;6;B;780;452;3;449;4;445;328;183;29;0;1;44;2;2;8;0;0;60;;6;;108;2
BIZKAIA;36;GALDAKAO;1;7;A;605;370;1;369;2;367;235;191;32;0;0;27;6;2;6;0;0;66;;1;;35;1
BIZKAIA;36;GALDAKAO;1;7;B;592;368;5;363;3;360;224;174;29;0;0;20;7;1;5;0;0;64;;2;;56;2
BIZKAIA;36;GALDAKAO;1;8;U;881;602;2;600;2;598;279;282;36;1;0;43;8;0;6;1;0;152;;0;;68;1
BIZKAIA;36;GALDAKAO;1;9;A;602;355;0;355;1;354;247;173;25;0;0;45;5;3;5;0;0;40;;1;;54;3
BIZKAIA;36;GALDAKAO;1;9;B;590;347;0;347;2;345;243;121;33;0;0;69;4;1;11;0;0;40;;3;;61;2
BIZKAIA;36;GALDAKAO;1;10;A;806;516;1;515;3;512;290;220;23;0;0;70;4;0;12;0;0;83;;1;;98;1
BIZKAIA;36;GALDAKAO;1;10;B;757;505;1;504;3;501;252;209;26;0;1;70;2;1;8;2;0;91;;1;;88;2
BIZKAIA;36;GALDAKAO;1;11;A;540;346;0;346;7;339;194;123;22;0;0;59;5;0;9;0;0;52;;1;;67;1
BIZKAIA;36;GALDAKAO;1;11;B;492;308;1;307;2;305;184;117;23;0;0;50;2;0;4;0;0;52;;1;;55;1
BIZKAIA;36;GALDAKAO;1;12;A;687;510;2;508;4;504;177;215;20;0;0;50;7;1;4;0;1;110;;2;;93;1
BIZKAIA;36;GALDAKAO;1;12;B;528;375;0;375;2;373;153;161;25;0;0;44;3;0;5;1;0;68;;2;;64;0
BIZKAIA;36;GALDAKAO;1;13;U;730;459;1;458;3;455;271;222;27;0;0;43;4;0;4;0;0;91;;2;;62;0
BIZKAIA;36;GALDAKAO;1;14;A;587;403;1;402;1;401;184;185;25;0;0;28;5;0;13;1;0;96;;0;;48;0
BIZKAIA;36;GALDAKAO;1;14;B;621;404;1;403;2;401;217;179;34;0;0;38;2;0;3;1;0;79;;2;;63;0
BIZKAIA;36;GALDAKAO;1;15;U;852;515;4;511;6;505;337;216;14;0;1;79;4;0;8;0;0;70;;3;;109;1
BIZKAIA;36;GALDAKAO;1;16;U;663;455;3;452;6;446;208;205;36;0;0;39;3;1;8;0;0;99;;2;;52;1
BIZKAIA;36;GALDAKAO;1;17;U;673;464;4;460;2;458;209;191;26;1;1;28;2;0;8;0;0;110;;2;;89;0
BIZKAIA;36;GALDAKAO;1;18;U;936;637;1;636;7;629;299;269;42;0;0;64;6;2;14;0;1;116;;4;;107;4
BIZKAIA;36;GALDAKAO;2;1;A;656;334;3;331;2;329;322;122;23;1;0;57;1;2;8;0;0;51;;4;;59;1
BIZKAIA;36;GALDAKAO;2;1;B;715;363;3;360;4;356;352;133;22;0;1;55;5;1;7;1;0;48;;3;;80;0
BIZKAIA;36;GALDAKAO;3;1;U;566;350;4;346;2;344;216;187;12;0;0;13;2;0;2;1;0;78;;0;;47;2
BIZKAIA;36;GALDAKAO;4;1;U;816;486;0;486;4;482;330;187;28;1;0;29;8;1;8;1;0;119;;6;;91;3
BIZKAIA;36;GALDAKAO;4;2;A;675;445;2;443;2;441;230;205;14;3;1;38;4;1;5;0;0;111;;3;;56;0
BIZKAIA;36;GALDAKAO;4;2;B;587;388;6;382;2;380;199;162;18;0;1;28;2;0;2;0;0;100;;2;;65;0
BIZKAIA;36;GALDAKAO;4;3;A;857;562;2;560;4;556;295;241;17;1;0;29;4;2;9;0;1;166;;5;;80;1
BIZKAIA;36;GALDAKAO;4;3;B;742;474;3;471;2;469;268;219;19;0;2;26;4;0;8;1;0;116;;2;;72;0
BIZKAIA;37;GALDAMES;1;1;A;342;247;1;246;1;245;95;134;3;0;0;6;1;0;2;0;0;67;;1;;31;0
BIZKAIA;37;GALDAMES;1;1;B;336;243;1;242;2;240;93;133;9;0;0;11;1;0;0;2;0;50;;1;;33;0
BIZKAIA;38;GAMIZ-FIKA;1;1;A;623;441;2;439;1;438;182;221;16;0;0;11;3;2;2;0;0;143;;4;;36;0
BIZKAIA;38;GAMIZ-FIKA;1;1;B;501;381;5;376;0;376;120;232;10;0;0;3;0;0;0;0;0;98;;0;;33;0
BIZKAIA;39;GARAI;1;1;U;237;193;1;192;2;190;44;108;5;0;0;3;0;0;4;1;0;64;;0;;5;0
BIZKAIA;40;GATIKA;1;1;A;748;537;4;533;3;530;211;296;5;0;0;12;5;1;3;0;0;169;;1;;38;0
BIZKAIA;40;GATIKA;1;1;B;532;356;5;351;2;349;176;191;12;0;0;12;6;0;2;0;0;79;;4;;43;0
BIZKAIA;41;GAUTEGIZ ARTEAGA;1;1;U;694;547;2;545;4;541;147;319;8;0;0;13;4;0;5;1;0;153;;1;;37;0
BIZKAIA;42;GORDEXOLA;1;1;A;654;508;7;501;2;499;146;290;34;0;2;25;7;0;8;0;0;66;;1;;64;2
BIZKAIA;42;GORDEXOLA;1;1;B;710;523;1;522;3;519;187;306;47;0;0;23;7;0;9;0;1;55;;1;;68;2
BIZKAIA;43;GORLIZ;1;1;A;730;491;1;490;1;489;239;240;20;0;0;23;1;0;9;2;0;119;;2;;72;1
BIZKAIA;43;GORLIZ;1;1;B;746;477;2;475;4;471;269;195;26;1;0;23;7;1;10;0;0;126;;4;;76;2
BIZKAIA;43;GORLIZ;1;2;A;597;418;1;417;1;416;179;226;21;0;0;25;6;0;2;0;0;84;;0;;52;0
BIZKAIA;43;GORLIZ;1;2;B;564;406;0;406;0;406;158;202;26;0;0;15;0;0;4;0;0;99;;5;;55;0
BIZKAIA;43;GORLIZ;1;3;A;951;623;2;621;7;614;328;342;40;0;0;27;5;1;12;1;0;121;;1;;64;0
BIZKAIA;43;GORLIZ;1;3;B;845;551;1;550;2;548;294;267;29;1;1;24;6;0;11;1;1;123;;1;;80;3
BIZKAIA;44;GETXO;1;1;U;861;611;0;611;6;605;250;313;94;0;1;61;4;1;23;1;0;55;;1;;51;0
BIZKAIA;44;GETXO;1;2;A;548;342;0;342;3;339;206;143;31;0;0;31;4;0;6;0;1;59;;2;;62;0
BIZKAIA;44;GETXO;1;2;B;535;357;0;357;0;357;178;126;40;0;0;48;2;0;10;2;0;62;;0;;67;0
BIZKAIA;44;GETXO;1;3;A;645;453;0;453;2;451;192;238;86;0;0;37;5;0;3;3;0;44;;1;;34;0
BIZKAIA;44;GETXO;1;3;B;591;418;1;417;0;417;173;167;98;0;0;21;7;2;11;0;1;68;;1;;40;1
BIZKAIA;44;GETXO;1;4;A;764;519;1;518;3;515;245;240;46;2;0;45;2;1;14;3;0;89;;1;;72;0
BIZKAIA;44;GETXO;1;4;B;748;513;0;513;5;508;235;229;37;1;1;43;2;0;13;1;0;102;;2;;74;3
BIZKAIA;44;GETXO;1;5;A;628;454;3;451;0;451;174;192;61;0;0;38;5;0;16;1;0;77;;3;;58;0
BIZKAIA;44;GETXO;1;5;B;634;451;2;449;1;448;183;185;72;0;0;55;1;0;13;0;1;62;;3;;56;0
BIZKAIA;44;GETXO;1;6;A;478;315;0;315;2;313;163;138;29;0;0;22;3;1;4;0;0;65;;0;;50;1
BIZKAIA;44;GETXO;1;6;B;471;300;2;298;0;298;171;123;15;0;2;26;5;0;8;0;0;70;;0;;49;0
BIZKAIA;44;GETXO;1;7;A;643;384;1;383;2;381;259;150;20;0;0;38;3;2;14;2;0;71;;3;;78;0
BIZKAIA;44;GETXO;1;7;B;605;377;0;377;1;376;228;149;28;0;1;40;5;0;16;1;0;72;;3;;60;1
BIZKAIA;44;GETXO;1;8;A;659;481;1;480;2;478;178;251;55;0;0;32;2;1;12;1;1;74;;2;;46;1
BIZKAIA;44;GETXO;1;8;B;619;445;0;445;5;440;174;209;63;0;1;46;5;0;10;1;0;61;;1;;43;0
BIZKAIA;44;GETXO;1;9;A;935;652;5;647;3;644;283;336;60;0;2;54;5;1;17;1;0;103;;0;;65;0
BIZKAIA;44;GETXO;1;9;B;817;551;2;549;2;547;266;267;64;0;0;59;4;0;9;0;0;99;;3;;42;0
BIZKAIA;44;GETXO;2;1;A;803;572;1;571;5;566;231;264;74;0;2;52;5;2;27;0;0;74;;4;;61;1
BIZKAIA;44;GETXO;2;1;B;761;529;0;529;8;521;232;261;66;0;0;38;3;2;15;0;0;68;;4;;61;3
BIZKAIA;44;GETXO;2;2;U;682;477;1;476;5;471;205;193;92;0;0;31;6;0;18;0;0;83;;2;;46;0
BIZKAIA;44;GETXO;2;3;A;622;430;1;429;4;425;192;208;44;1;0;11;2;0;8;0;0;108;;2;;40;1
BIZKAIA;44;GETXO;2;3;B;548;382;1;381;1;380;166;174;36;0;0;22;1;0;8;0;1;98;;0;;40;0
BIZKAIA;44;GETXO;2;4;U;609;460;2;458;4;454;149;194;64;0;0;13;7;0;15;2;0;113;;1;;45;0
BIZKAIA;44;GETXO;2;5;U;816;553;3;550;1;549;263;267;58;0;0;31;6;0;10;1;0;113;;2;;61;0
BIZKAIA;44;GETXO;2;6;A;583;381;1;380;1;379;202;174;16;1;0;40;4;0;6;0;0;92;;1;;44;1
BIZKAIA;44;GETXO;2;6;B;518;323;1;322;5;317;195;130;15;0;1;25;2;0;8;0;0;81;;1;;52;2
BIZKAIA;44;GETXO;2;7;A;640;388;1;387;2;385;252;166;25;0;0;31;5;1;14;0;1;89;;4;;49;0
BIZKAIA;44;GETXO;2;7;B;612;391;1;390;4;386;221;157;43;0;1;29;4;0;17;0;0;74;;6;;55;0
BIZKAIA;44;GETXO;2;8;A;574;381;0;381;2;379;193;175;69;0;0;22;1;2;10;2;0;49;;3;;45;1
BIZKAIA;44;GETXO;2;8;B;538;332;0;332;2;330;206;125;46;0;0;23;2;1;7;0;0;67;;0;;59;0
BIZKAIA;44;GETXO;2;9;A;584;429;0;429;1;428;155;124;242;1;1;15;1;0;16;0;0;13;;0;;14;1
BIZKAIA;44;GETXO;2;9;B;476;339;0;339;0;339;137;102;192;0;0;16;3;0;5;0;0;8;;0;;13;0
BIZKAIA;44;GETXO;2;10;A;649;430;0;430;0;430;219;122;227;0;0;19;0;1;13;0;0;26;;1;;21;0
BIZKAIA;44;GETXO;2;10;B;576;377;0;377;2;375;199;107;195;0;0;14;8;0;7;0;0;22;;0;;20;2
BIZKAIA;44;GETXO;2;11;U;637;413;1;412;4;408;224;180;32;0;0;24;2;1;6;1;0;97;;2;;62;1
BIZKAIA;44;GETXO;2;12;A;595;389;0;389;2;387;206;173;36;0;0;40;2;0;7;0;0;84;;4;;41;0
BIZKAIA;44;GETXO;2;12;B;541;333;1;332;3;329;208;154;26;0;0;21;3;0;12;1;0;72;;0;;40;0
BIZKAIA;44;GETXO;2;13;A;670;429;2;427;5;422;241;190;60;0;1;39;4;2;8;1;0;64;;5;;47;1
BIZKAIA;44;GETXO;2;13;B;606;398;0;398;3;395;208;185;48;0;1;50;3;1;4;0;1;47;;2;;52;1
BIZKAIA;44;GETXO;2;14;U;893;613;2;611;6;605;280;248;40;0;0;55;5;1;12;2;0;168;;2;;70;2
BIZKAIA;44;GETXO;2;15;A;536;342;1;341;2;339;194;139;122;0;2;23;0;0;17;0;0;21;;0;;12;3
BIZKAIA;44;GETXO;2;15;B;550;354;0;354;2;352;196;142;111;0;0;31;0;1;19;1;0;19;;1;;27;0
BIZKAIA;44;GETXO;2;16;U;760;526;2;524;2;522;234;241;98;0;0;41;2;1;12;0;0;69;;3;;53;2
BIZKAIA;44;GETXO;2;17;U;770;514;0;514;4;510;256;229;32;1;0;58;4;0;8;1;0;94;;3;;78;2
BIZKAIA;44;GETXO;2;18;U;740;490;2;488;2;486;250;208;35;0;0;44;5;0;11;0;1;94;;0;;87;1
BIZKAIA;44;GETXO;2;19;A;834;526;3;523;4;519;308;235;93;2;0;45;7;2;17;2;0;46;;1;;67;2
BIZKAIA;44;GETXO;2;19;B;676;429;2;427;4;423;247;179;80;0;0;33;3;1;17;1;0;56;;0;;52;1
BIZKAIA;44;GETXO;2;20;A;596;356;3;353;3;350;240;140;27;1;0;43;6;2;5;2;0;63;;2;;59;0
BIZKAIA;44;GETXO;2;20;B;536;307;2;305;3;302;229;125;25;0;0;42;4;0;7;0;0;56;;1;;42;0
BIZKAIA;44;GETXO;2;21;A;569;402;4;398;4;394;167;184;68;0;0;34;0;0;9;0;0;62;;2;;34;1
BIZKAIA;44;GETXO;2;21;B;514;362;3;359;3;356;152;156;54;0;0;27;1;0;12;0;0;67;;2;;36;1
BIZKAIA;44;GETXO;2;22;A;558;382;1;381;2;379;176;187;43;1;0;23;0;0;8;0;0;83;;0;;33;1
BIZKAIA;44;GETXO;2;22;B;536;351;1;350;2;348;185;162;52;0;1;32;3;0;8;0;1;47;;0;;41;1
BIZKAIA;44;GETXO;2;23;U;733;533;0;533;1;532;200;125;368;1;0;5;2;2;14;1;0;3;;0;;9;2
BIZKAIA;44;GETXO;2;24;U;718;473;1;472;8;464;245;225;45;0;0;44;3;0;13;1;0;74;;2;;57;0
BIZKAIA;44;GETXO;2;25;U;685;443;0;443;2;441;242;175;32;0;0;42;4;0;11;1;0;99;;5;;72;0
BIZKAIA;44;GETXO;2;26;U;883;612;0;612;4;608;271;245;120;0;0;57;4;1;21;1;0;102;;3;;53;1
BIZKAIA;44;GETXO;2;27;U;610;427;2;425;4;421;183;183;55;0;1;34;2;1;10;0;0;77;;0;;57;1
BIZKAIA;44;GETXO;2;28;U;614;427;1;426;3;423;187;187;42;1;0;29;1;1;5;1;1;105;;3;;47;0
BIZKAIA;44;GETXO;2;29;U;549;371;1;370;2;368;178;166;31;0;0;34;3;0;10;1;0;71;;1;;51;0
BIZKAIA;44;GETXO;2;30;A;627;426;0;426;3;423;201;192;80;0;0;37;3;0;15;0;0;45;;5;;45;1
BIZKAIA;44;GETXO;2;30;B;551;366;1;365;0;365;185;168;83;2;0;29;0;1;12;0;0;38;;1;;30;1
BIZKAIA;44;GETXO;2;31;U;800;539;0;539;4;535;261;154;300;0;1;23;4;1;27;0;0;5;;2;;17;1
BIZKAIA;44;GETXO;2;32;U;836;545;0;545;1;544;291;214;132;0;0;45;0;3;23;2;1;53;;1;;69;1
BIZKAIA;44;GETXO;3;1;U;894;639;0;639;4;635;255;198;329;0;0;43;4;0;36;3;0;7;;2;;12;1
BIZKAIA;44;GETXO;3;2;U;810;577;0;577;3;574;233;221;233;1;0;39;1;2;23;0;0;31;;0;;23;0
BIZKAIA;44;GETXO;3;3;U;900;631;2;629;9;620;269;202;307;0;0;25;2;1;33;0;0;23;;1;;26;0
BIZKAIA;44;GETXO;3;4;A;723;486;0;486;3;483;237;209;147;0;2;35;3;1;16;0;0;37;;0;;31;2
BIZKAIA;44;GETXO;3;4;B;726;494;1;493;2;491;232;226;119;0;0;42;5;0;17;0;0;33;;2;;45;2
BIZKAIA;44;GETXO;3;5;A;761;525;3;522;6;516;236;226;86;0;1;43;5;0;21;2;0;64;;1;;66;1
BIZKAIA;44;GETXO;3;5;B;689;448;2;446;3;443;241;195;78;0;0;34;2;0;18;1;1;47;;5;;62;0
BIZKAIA;44;GETXO;3;6;U;931;646;3;643;8;635;285;264;167;0;0;65;3;1;24;0;2;58;;1;;50;0
BIZKAIA;44;GETXO;3;7;U;528;315;0;315;1;314;213;121;31;0;0;36;3;2;6;2;1;46;;0;;64;2
BIZKAIA;44;GETXO;3;8;U;937;535;2;533;6;527;402;209;35;0;0;38;3;2;14;0;0;124;;5;;97;0
BIZKAIA;44;GETXO;3;9;U;958;638;0;638;4;634;320;264;219;1;1;30;6;3;30;0;0;33;;1;;46;0
BIZKAIA;44;GETXO;3;10;A;577;406;2;404;3;401;171;180;94;0;0;38;2;1;14;1;0;31;;1;;39;0
BIZKAIA;44;GETXO;3;10;B;559;373;1;372;1;371;186;138;91;0;0;57;6;0;14;0;0;24;;1;;40;0
BIZKAIA;44;GETXO;3;11;U;691;481;2;479;2;477;210;224;93;1;1;44;2;3;18;2;0;36;;2;;49;2
BIZKAIA;44;GETXO;3;12;U;563;314;1;313;4;309;249;130;29;0;0;35;3;0;6;1;0;52;;1;;52;0
BIZKAIA;44;GETXO;3;13;A;617;436;0;436;1;435;181;154;194;1;0;24;1;1;16;0;0;16;;1;;26;1
BIZKAIA;44;GETXO;3;13;B;529;341;1;340;5;335;188;135;130;0;0;16;1;0;22;0;0;12;;0;;17;2
BIZKAIA;44;GETXO;3;14;U;925;621;2;619;3;616;304;246;211;1;0;51;2;3;17;4;0;46;;1;;33;1
BIZKAIA;44;GETXO;3;15;U;674;412;3;409;3;406;262;178;73;1;0;43;4;3;17;4;0;36;;3;;42;2
BIZKAIA;44;GETXO;3;16;U;669;458;3;455;1;454;211;194;48;1;0;56;1;0;6;0;0;72;;0;;75;1
BIZKAIA;44;GETXO;3;17;A;501;360;1;359;2;357;141;171;48;0;2;38;1;0;9;0;0;46;;2;;39;1
BIZKAIA;44;GETXO;3;17;B;562;398;0;398;2;396;164;150;44;0;0;59;0;0;8;0;0;69;;1;;64;1
BIZKAIA;44;GETXO;3;19;U;692;406;6;400;4;396;286;167;35;0;1;31;1;1;9;1;0;63;;6;;81;0
BIZKAIA;44;GETXO;3;20;U;576;363;0;363;1;362;213;159;34;0;1;29;1;0;6;0;0;70;;5;;57;0
BIZKAIA;44;GETXO;3;21;U;630;386;1;385;6;379;244;131;35;0;2;65;1;1;6;0;0;67;;3;;67;1
BIZKAIA;44;GETXO;3;22;U;914;636;0;636;3;633;278;271;194;0;0;55;5;1;27;0;0;30;;1;;48;1
BIZKAIA;44;GETXO;3;23;U;793;567;0;567;5;562;226;224;180;1;0;44;4;4;21;0;0;48;;2;;34;0
BIZKAIA;44;GETXO;3;24;U;575;363;0;363;4;359;212;166;67;0;0;31;2;1;7;1;0;44;;3;;37;0
BIZKAIA;44;GETXO;3;25;U;761;565;2;563;1;562;196;162;340;0;0;23;1;4;13;0;0;3;;1;;15;0
BIZKAIA;44;GETXO;3;26;U;543;385;2;383;2;381;158;171;78;0;0;35;2;0;7;1;1;39;;0;;47;0
BIZKAIA;45;GÜEÑES;1;1;A;630;425;5;420;4;416;205;222;17;0;1;29;5;0;3;1;0;72;;1;;62;3
BIZKAIA;45;GÜEÑES;1;1;B;685;460;4;456;4;452;225;259;21;0;0;26;4;0;4;0;1;71;;0;;66;0
BIZKAIA;45;GÜEÑES;2;1;A;398;273;5;268;1;267;125;142;12;0;0;30;2;3;2;0;0;50;;1;;25;0
BIZKAIA;45;GÜEÑES;2;1;B;550;383;5;378;4;374;167;176;10;0;1;38;2;1;3;0;0;92;;0;;51;0
BIZKAIA;45;GÜEÑES;2;2;A;558;424;3;421;8;413;134;237;9;0;0;34;5;1;5;2;0;70;;1;;49;0
BIZKAIA;45;GÜEÑES;2;2;B;575;425;4;421;4;417;150;211;27;2;1;42;2;1;10;0;0;66;;2;;53;0
BIZKAIA;45;GÜEÑES;2;3;A;595;403;7;396;2;394;192;193;15;1;0;42;3;1;2;1;0;79;;1;;56;0
BIZKAIA;45;GÜEÑES;2;3;B;616;447;1;446;7;439;169;218;13;0;0;35;2;0;3;0;0;97;;4;;67;0
BIZKAIA;45;GÜEÑES;2;4;A;234;184;1;183;1;182;50;106;2;0;0;4;0;0;4;0;0;50;;0;;16;0
BIZKAIA;45;GÜEÑES;2;4;B;334;229;2;227;0;227;105;94;8;0;0;22;1;1;4;0;0;58;;2;;37;0
BIZKAIA;46;GERNIKA-LUMO;1;1;A;667;460;3;457;3;454;207;229;20;0;0;12;0;3;4;1;0;161;;2;;22;0
BIZKAIA;46;GERNIKA-LUMO;1;1;B;554;399;4;395;1;394;155;184;18;0;1;28;0;0;2;0;0;124;;5;;30;2
BIZKAIA;46;GERNIKA-LUMO;1;2;U;844;594;1;593;5;588;250;348;17;0;0;7;4;0;1;0;0;164;;3;;44;0
BIZKAIA;46;GERNIKA-LUMO;1;3;A;539;403;3;400;3;397;136;195;14;0;0;12;0;0;1;0;0;148;;0;;27;0
BIZKAIA;46;GERNIKA-LUMO;1;3;B;416;294;4;290;2;288;122;154;4;0;0;19;1;0;2;0;0;86;;0;;22;0
BIZKAIA;46;GERNIKA-LUMO;1;4;A;599;406;0;406;0;406;193;165;19;0;2;26;3;1;4;3;1;123;;5;;53;1
BIZKAIA;46;GERNIKA-LUMO;1;4;B;491;331;0;331;3;328;160;139;11;0;0;37;4;0;2;0;0;96;;2;;37;0
BIZKAIA;46;GERNIKA-LUMO;1;5;A;571;391;1;390;3;387;180;207;7;0;0;11;0;0;2;0;0;130;;1;;29;0
BIZKAIA;46;GERNIKA-LUMO;1;5;B;475;331;0;331;1;330;144;189;6;0;0;10;3;2;5;2;0;92;;0;;21;0
BIZKAIA;46;GERNIKA-LUMO;1;6;U;858;663;2;661;4;657;195;363;21;0;0;19;1;1;7;2;0;193;;3;;46;1
BIZKAIA;46;GERNIKA-LUMO;1;7;A;803;580;2;578;1;577;223;247;18;0;0;39;0;0;4;1;0;229;;6;;33;0
BIZKAIA;46;GERNIKA-LUMO;1;7;B;692;470;2;468;6;462;222;203;26;0;0;25;2;0;2;0;1;154;;3;;46;0
BIZKAIA;46;GERNIKA-LUMO;1;8;U;688;527;0;527;2;525;161;295;12;0;0;8;3;0;4;0;0;162;;0;;41;0
BIZKAIA;46;GERNIKA-LUMO;1;9;A;613;461;1;460;1;459;152;178;15;0;0;30;2;0;5;1;0;172;;2;;53;1
BIZKAIA;46;GERNIKA-LUMO;1;9;B;532;364;2;362;4;358;168;135;9;0;0;24;5;1;4;0;0;125;;3;;51;1
BIZKAIA;46;GERNIKA-LUMO;2;1;A;809;541;0;541;2;539;268;232;25;0;0;30;1;0;5;1;0;199;;1;;45;0
BIZKAIA;46;GERNIKA-LUMO;2;1;B;652;423;3;420;3;417;229;172;27;0;0;31;3;0;6;1;0;122;;2;;52;1
BIZKAIA;46;GERNIKA-LUMO;2;2;U;926;637;4;633;5;628;289;301;8;0;0;28;8;1;7;0;0;213;;1;;60;1
BIZKAIA;46;GERNIKA-LUMO;2;3;U;888;583;6;577;3;574;305;276;33;0;0;43;3;0;7;1;0;145;;2;;63;1
BIZKAIA;47;GIZABURUAGA;1;1;U;160;115;3;112;0;112;45;32;1;0;0;0;0;0;0;0;0;69;;0;;10;0
BIZKAIA;48;IBARRANGELU;1;1;U;558;385;1;384;5;379;173;193;5;0;0;8;3;0;0;1;0;145;;0;;24;0
BIZKAIA;49;ISPASTER;1;1;U;549;430;0;430;3;427;119;218;7;0;1;0;2;1;0;2;0;167;;2;;27;0
BIZKAIA;50;IZURTZA;1;1;U;193;148;1;147;0;147;45;70;3;0;0;1;0;0;0;0;0;69;;0;;4;0
BIZKAIA;51;LANESTOSA;1;1;U;214;151;1;150;1;149;63;80;3;0;0;14;2;1;2;0;0;27;;2;;17;1
BIZKAIA;52;LARRABETZU;1;1;A;834;637;1;636;1;635;197;248;10;1;0;10;2;0;0;2;0;319;;2;;40;1
BIZKAIA;52;LARRABETZU;1;1;B;727;548;2;546;0;546;179;210;13;0;0;2;3;0;3;0;0;279;;1;;35;0
BIZKAIA;53;LAUKIZ;1;1;U;897;659;2;657;5;652;238;376;78;0;0;25;3;1;13;0;1;125;;3;;27;0
BIZKAIA;54;LEIOA;1;1;A;710;430;3;427;1;426;280;194;37;0;0;53;4;0;8;1;0;48;;6;;74;1
BIZKAIA;54;LEIOA;1;1;B;674;411;2;409;0;409;263;185;29;0;0;58;9;1;9;0;0;44;;4;;68;2
BIZKAIA;54;LEIOA;1;2;A;685;447;2;445;0;445;238;188;42;1;0;66;2;0;12;1;0;68;;1;;64;0
BIZKAIA;54;LEIOA;1;2;B;715;461;3;458;2;456;254;199;49;1;1;58;4;1;17;1;0;53;;4;;67;1
BIZKAIA;54;LEIOA;1;3;A;603;364;2;362;3;359;239;148;24;1;2;40;3;2;5;0;0;54;;1;;77;2
BIZKAIA;54;LEIOA;1;3;B;579;345;2;343;3;340;234;133;22;2;2;45;8;0;10;2;0;40;;3;;72;1
BIZKAIA;54;LEIOA;1;4;U;554;327;0;327;1;326;227;122;25;0;0;41;2;1;6;2;0;60;;4;;62;1
BIZKAIA;54;LEIOA;1;5;U;655;389;1;388;1;387;266;190;21;0;1;49;2;0;7;2;0;54;;1;;60;0
BIZKAIA;54;LEIOA;1;6;A;455;325;0;325;7;318;130;146;38;0;0;31;1;2;5;0;0;32;;3;;60;0
BIZKAIA;54;LEIOA;1;6;B;471;334;2;332;3;329;137;115;59;0;0;39;1;0;17;3;1;37;;5;;51;1
BIZKAIA;54;LEIOA;1;7;A;641;395;1;394;4;390;246;143;32;1;0;73;2;1;8;0;0;52;;1;;74;3
BIZKAIA;54;LEIOA;1;7;B;685;411;1;410;2;408;274;166;33;0;0;57;3;0;15;2;0;53;;4;;75;0
BIZKAIA;54;LEIOA;1;8;A;645;411;0;411;4;407;234;158;42;1;0;55;5;3;7;0;0;65;;8;;58;5
BIZKAIA;54;LEIOA;1;8;B;625;384;2;382;3;379;241;168;30;3;0;46;0;1;11;2;0;54;;4;;60;0
BIZKAIA;54;LEIOA;1;9;A;484;270;0;270;1;269;214;121;24;1;1;31;5;2;10;1;0;35;;1;;37;0
BIZKAIA;54;LEIOA;1;9;B;457;277;0;277;1;276;180;111;25;1;0;33;7;0;3;0;2;43;;3;;47;1
BIZKAIA;54;LEIOA;2;1;A;708;425;2;423;1;422;283;166;19;0;0;55;8;0;4;1;0;86;;3;;78;2
BIZKAIA;54;LEIOA;2;1;B;762;459;1;458;3;455;303;156;15;0;1;44;8;1;6;0;1;109;;3;;108;3
BIZKAIA;54;LEIOA;2;2;A;586;347;0;347;3;344;239;131;49;0;0;51;5;0;9;2;0;38;;2;;57;0
BIZKAIA;54;LEIOA;2;2;B;588;372;0;372;1;371;216;149;45;0;0;43;6;0;12;0;0;40;;2;;74;0
BIZKAIA;54;LEIOA;2;3;A;483;282;1;281;2;279;201;111;23;0;0;46;2;1;3;1;4;35;;3;;49;1
BIZKAIA;54;LEIOA;2;3;B;487;288;1;287;1;286;199;108;30;1;0;58;1;0;5;0;1;23;;2;;54;3
BIZKAIA;54;LEIOA;3;1;A;668;443;4;439;5;434;225;190;24;0;0;39;2;0;5;1;0;77;;3;;93;0
BIZKAIA;54;LEIOA;3;1;B;675;418;4;414;1;413;257;190;14;0;0;45;1;0;6;2;0;60;;6;;89;0
BIZKAIA;54;LEIOA;3;2;A;459;287;0;287;1;286;172;122;23;0;0;28;7;3;6;0;0;33;;1;;63;0
BIZKAIA;54;LEIOA;3;2;B;521;343;1;342;3;339;178;154;28;0;0;26;3;2;5;0;0;39;;3;;75;4
BIZKAIA;54;LEIOA;3;3;A;881;527;0;527;6;521;354;257;49;0;0;39;6;1;9;1;0;60;;2;;97;0
BIZKAIA;54;LEIOA;3;3;B;885;536;3;533;5;528;349;216;43;0;1;60;7;0;19;2;1;61;;1;;114;3
BIZKAIA;54;LEIOA;3;4;U;750;497;6;491;5;486;253;202;75;0;0;57;4;1;8;1;0;62;;2;;74;0
BIZKAIA;54;LEIOA;3;5;U;841;494;2;492;1;491;347;161;43;1;1;75;4;3;15;2;0;65;;9;;111;1
BIZKAIA;54;LEIOA;3;6;A;453;291;1;290;2;288;162;136;23;0;0;35;4;0;10;1;0;30;;0;;48;1
BIZKAIA;54;LEIOA;3;6;B;430;276;1;275;1;274;154;132;23;1;0;43;3;0;9;0;0;22;;0;;40;1
BIZKAIA;54;LEIOA;3;7;A;706;454;1;453;2;451;252;204;28;0;0;38;3;0;6;0;1;81;;3;;84;3
BIZKAIA;54;LEIOA;3;7;B;739;461;2;459;4;455;278;178;36;0;0;56;2;0;11;1;0;60;;7;;102;2
BIZKAIA;54;LEIOA;3;8;A;955;629;0;629;6;623;326;268;117;0;0;46;16;0;26;1;0;61;;3;;82;3
BIZKAIA;54;LEIOA;3;8;B;884;592;2;590;5;585;292;256;104;0;1;47;9;0;25;1;0;59;;5;;75;3
BIZKAIA;54;LEIOA;3;9;A;529;385;1;384;5;379;144;161;99;1;0;38;2;0;18;0;0;29;;1;;30;0
BIZKAIA;54;LEIOA;3;9;B;579;376;0;376;2;374;203;155;91;2;0;41;6;0;16;1;0;18;;2;;40;2
BIZKAIA;55;LEMOA;1;1;U;699;485;2;483;1;482;214;250;17;0;1;11;1;0;4;0;1;157;;1;;39;0
BIZKAIA;55;LEMOA;1;2;A;673;483;6;477;4;473;190;191;13;1;0;18;0;2;6;2;0;177;;2;;59;2
BIZKAIA;55;LEMOA;1;2;B;536;356;3;353;2;351;180;142;10;1;1;34;0;1;5;0;0;103;;4;;49;1
BIZKAIA;55;LEMOA;1;3;U;754;507;7;500;2;498;247;189;13;0;0;22;2;2;5;1;1;193;;1;;68;1
BIZKAIA;56;LEMOIZ;1;1;A;517;366;0;366;2;364;151;212;4;0;0;3;3;0;1;1;0;107;;1;;31;1
BIZKAIA;56;LEMOIZ;1;1;B;452;315;1;314;4;310;137;163;5;0;0;5;1;1;1;0;0;95;;3;;36;0
BIZKAIA;57;LEKEITIO;1;1;U;625;458;0;458;2;456;167;182;4;0;0;2;0;0;4;0;0;237;;2;;25;0
BIZKAIA;57;LEKEITIO;1;2;U;721;539;1;538;2;536;182;226;6;1;0;3;0;1;1;0;0;268;;2;;28;0
BIZKAIA;57;LEKEITIO;2;1;U;566;415;2;413;1;412;151;179;5;0;0;9;0;1;0;0;0;192;;1;;24;1
BIZKAIA;57;LEKEITIO;2;2;U;930;650;1;649;3;646;280;313;3;0;0;4;0;0;2;0;0;289;;1;;34;0
BIZKAIA;57;LEKEITIO;2;3;U;856;623;2;621;0;621;233;311;3;0;0;12;0;0;3;0;0;259;;2;;31;0
BIZKAIA;57;LEKEITIO;2;4;U;1003;725;2;723;1;722;278;321;3;0;0;7;1;0;3;0;0;337;;2;;48;0
BIZKAIA;57;LEKEITIO;2;5;U;999;678;2;676;5;671;321;292;12;0;0;17;0;0;1;0;0;293;;0;;56;0
BIZKAIA;58;MALLABIA;1;1;U;969;655;2;653;4;649;314;266;14;0;0;33;0;1;6;1;0;268;;5;;54;1
BIZKAIA;59;MAÑARIA;1;1;U;402;309;3;306;1;305;93;150;8;0;0;7;1;1;0;0;0;119;;1;;17;1
BIZKAIA;60;MARKINA-XEMEIN;1;1;A;755;498;2;496;1;495;257;262;5;0;0;8;0;1;2;0;0;187;;0;;30;0
BIZKAIA;60;MARKINA-XEMEIN;1;1;B;509;315;2;313;0;313;194;146;4;0;0;3;1;1;1;0;0;136;;0;;21;0
BIZKAIA;60;MARKINA-XEMEIN;1;2;A;767;518;0;518;1;517;249;277;10;0;0;7;0;1;1;0;0;180;;1;;40;0
BIZKAIA;60;MARKINA-XEMEIN;1;2;B;578;381;1;380;3;377;197;186;2;0;0;7;0;1;1;0;0;145;;0;;35;0
BIZKAIA;60;MARKINA-XEMEIN;1;3;A;641;409;1;408;3;405;232;218;7;0;0;4;1;0;1;0;0;152;;0;;22;0
BIZKAIA;60;MARKINA-XEMEIN;1;3;B;382;238;0;238;1;237;144;104;6;0;1;3;1;0;0;0;0;102;;0;;20;0
BIZKAIA;61;MARURI-JATABE;1;1;U;765;558;4;554;0;554;207;306;22;1;0;15;6;1;6;0;2;131;;3;;56;5
BIZKAIA;62;MENDATA;1;1;U;302;234;0;234;1;233;68;126;0;0;0;1;0;1;1;0;0;86;;0;;18;0
BIZKAIA;63;MENDEXA;1;1;U;371;282;5;277;1;276;89;134;2;2;0;5;2;0;0;0;0;114;;1;;16;0
BIZKAIA;64;MEÑAKA;1;1;U;602;442;1;441;1;440;160;208;4;0;0;2;1;2;0;0;0;186;;2;;34;1
BIZKAIA;65;UGAO-MIRABALLES;1;1;A;495;335;6;329;2;327;160;151;13;0;0;11;4;1;0;0;0;107;;2;;38;0
BIZKAIA;65;UGAO-MIRABALLES;1;1;B;559;377;2;375;1;374;182;163;22;1;0;29;3;0;4;0;0;106;;0;;46;0
BIZKAIA;65;UGAO-MIRABALLES;1;2;U;612;411;2;409;1;408;201;179;17;0;0;41;3;0;5;0;0;108;;3;;51;1
BIZKAIA;65;UGAO-MIRABALLES;1;3;U;700;451;0;451;2;449;249;187;17;0;1;42;1;1;2;2;0;129;;4;;62;1
BIZKAIA;65;UGAO-MIRABALLES;1;4;U;928;612;3;609;3;606;316;290;21;0;0;40;2;2;7;0;0;148;;12;;83;1
BIZKAIA;66;MORGA;1;1;U;350;272;0;272;0;272;78;169;4;0;0;0;2;0;0;1;0;83;;0;;13;0
BIZKAIA;67;MUXIKA;1;1;A;575;407;0;407;2;405;168;187;5;0;0;8;1;0;5;0;0;172;;0;;27;0
BIZKAIA;67;MUXIKA;1;1;B;383;262;1;261;1;260;121;109;2;0;0;2;1;1;1;2;0;111;;1;;30;0
BIZKAIA;67;MUXIKA;1;1;C;197;150;0;150;0;150;47;85;0;0;0;0;0;0;0;0;1;59;;0;;5;0
BIZKAIA;68;MUNDAKA;1;1;A;758;558;3;555;4;551;200;338;5;0;0;6;2;1;1;1;0;140;;3;;54;0
BIZKAIA;68;MUNDAKA;1;1;B;795;589;5;584;2;582;206;335;5;1;0;10;1;0;2;0;0;184;;0;;44;0
BIZKAIA;69;MUNGIA;1;1;A;758;507;5;502;4;498;251;281;14;1;0;20;2;0;3;2;0;118;;8;;47;2
BIZKAIA;69;MUNGIA;1;1;B;581;353;3;350;3;347;228;198;8;0;0;8;4;1;1;1;0;89;;3;;32;2
BIZKAIA;69;MUNGIA;1;2;A;864;556;3;553;0;553;308;308;12;0;0;29;1;1;8;0;0;124;;1;;67;2
BIZKAIA;69;MUNGIA;1;2;B;758;473;2;471;1;470;285;248;19;0;0;27;1;0;11;0;1;103;;0;;58;2
BIZKAIA;69;MUNGIA;1;3;A;852;575;1;574;1;573;277;276;14;0;2;50;4;0;8;1;1;111;;7;;97;2
BIZKAIA;69;MUNGIA;1;3;B;818;518;7;511;2;509;300;253;18;1;0;40;3;1;8;1;0;93;;8;;82;1
BIZKAIA;69;MUNGIA;1;4;A;645;424;2;422;4;418;221;250;9;0;0;10;1;1;5;1;0;94;;0;;47;0
BIZKAIA;69;MUNGIA;1;4;B;573;381;1;380;2;378;192;205;13;0;0;9;3;0;6;0;0;82;;1;;56;3
BIZKAIA;69;MUNGIA;1;5;U;684;482;2;480;4;476;202;275;8;0;0;16;0;1;3;0;0;108;;4;;59;2
BIZKAIA;69;MUNGIA;1;6;A;545;365;2;363;2;361;180;215;11;0;1;10;2;0;6;0;1;80;;1;;34;0
BIZKAIA;69;MUNGIA;1;6;B;467;304;3;301;1;300;163;190;8;0;0;18;4;0;4;1;0;49;;2;;23;1
BIZKAIA;69;MUNGIA;1;7;U;837;521;1;520;4;516;316;254;15;0;0;37;3;1;6;2;0;117;;4;;77;0
BIZKAIA;69;MUNGIA;1;8;A;700;498;1;497;3;494;202;269;10;1;0;21;3;1;2;0;1;120;;5;;61;0
BIZKAIA;69;MUNGIA;1;8;B;700;468;2;466;2;464;232;236;15;0;1;23;0;0;9;1;1;106;;1;;70;1
BIZKAIA;69;MUNGIA;2;1;A;535;316;2;314;0;314;219;174;10;0;0;7;2;1;4;0;0;94;;2;;20;0
BIZKAIA;69;MUNGIA;2;1;B;454;259;0;259;1;258;195;113;9;0;0;10;1;1;2;2;0;85;;1;;34;0
BIZKAIA;69;MUNGIA;2;2;A;545;360;1;359;4;355;185;174;81;0;0;15;0;2;12;1;0;52;;1;;17;0
BIZKAIA;69;MUNGIA;2;2;B;409;269;0;269;0;269;140;103;97;0;0;14;6;1;15;0;0;15;;0;;18;0
BIZKAIA;69;MUNGIA;2;3;U;1070;686;1;685;2;683;384;315;201;1;1;40;7;3;34;0;0;35;;1;;45;0
BIZKAIA;70;AULESTI;1;1;U;540;378;4;374;0;374;162;123;1;0;0;0;0;0;1;0;0;234;;0;;15;0
BIZKAIA;71;MUSKIZ;1;1;U;591;395;3;392;1;391;196;207;36;1;0;40;2;0;3;0;0;44;;3;;54;1
BIZKAIA;71;MUSKIZ;1;2;A;633;432;3;429;0;429;201;193;10;0;0;57;5;1;6;0;0;81;;4;;72;0
BIZKAIA;71;MUSKIZ;1;2;B;635;431;2;429;1;428;204;218;16;0;2;68;3;0;1;0;0;43;;2;;74;1
BIZKAIA;71;MUSKIZ;1;3;A;596;358;1;357;1;356;238;155;15;1;1;60;2;0;2;0;0;43;;1;;75;1
BIZKAIA;71;MUSKIZ;1;3;B;570;367;0;367;1;366;203;150;11;0;0;82;2;0;1;0;0;45;;0;;75;0
BIZKAIA;71;MUSKIZ;1;4;A;743;489;3;486;3;483;254;211;4;2;0;79;4;0;4;1;0;68;;4;;103;3
BIZKAIA;71;MUSKIZ;1;4;B;657;444;3;441;5;436;213;175;7;0;1;59;5;1;8;0;0;90;;1;;87;2
BIZKAIA;71;MUSKIZ;1;5;U;749;496;5;491;3;488;253;200;7;0;1;52;6;0;5;1;0;109;;2;;105;0
BIZKAIA;71;MUSKIZ;2;1;A;448;294;2;292;0;292;154;147;18;0;0;38;3;1;5;0;0;42;;2;;36;0
BIZKAIA;71;MUSKIZ;2;1;B;476;325;3;322;2;320;151;149;10;0;0;37;5;0;6;0;0;61;;2;;49;1
BIZKAIA;72;OTXANDIO;1;1;A;521;394;1;393;3;390;127;156;4;0;0;5;0;0;0;0;0;204;;0;;20;1
BIZKAIA;72;OTXANDIO;1;1;B;448;349;2;347;0;347;99;135;6;0;0;8;1;0;0;0;0;169;;2;;26;0
BIZKAIA;73;ONDARROA;1;1;A;669;411;4;407;3;404;258;144;5;0;0;9;1;0;0;0;0;216;;0;;29;0
BIZKAIA;73;ONDARROA;1;1;B;468;276;1;275;2;273;192;110;5;0;1;4;1;0;0;0;0;128;;0;;24;0
BIZKAIA;73;ONDARROA;1;2;U;763;535;3;532;1;531;228;214;24;1;0;3;2;2;1;1;0;243;;1;;39;0
BIZKAIA;73;ONDARROA;1;3;U;857;595;3;592;4;588;262;277;39;0;0;4;1;0;1;0;0;237;;2;;27;0
BIZKAIA;73;ONDARROA;2;1;U;520;335;0;335;3;332;185;147;3;0;0;6;2;0;1;1;0;149;;1;;22;0
BIZKAIA;73;ONDARROA;2;2;A;799;509;3;506;4;502;290;191;13;0;0;3;1;0;2;0;0;246;;0;;46;0
BIZKAIA;73;ONDARROA;2;2;B;493;276;1;275;2;273;217;104;6;0;0;0;0;0;0;0;0;136;;0;;26;1
BIZKAIA;73;ONDARROA;2;3;A;851;543;4;539;5;534;308;148;13;0;0;8;3;0;1;0;0;306;;0;;55;0
BIZKAIA;73;ONDARROA;2;3;B;665;409;1;408;4;404;256;118;4;0;0;13;3;0;0;0;0;216;;0;;50;0
BIZKAIA;73;ONDARROA;3;1;U;799;473;1;472;2;470;326;193;17;1;0;24;1;0;5;0;0;180;;1;;48;0
BIZKAIA;74;URDUÑA/ORDUÑA;1;1;U;884;566;7;559;4;555;318;229;29;0;0;44;1;1;13;1;0;157;;4;;76;0
BIZKAIA;74;URDUÑA/ORDUÑA;1;2;U;959;630;4;626;4;622;329;275;50;0;0;37;2;3;7;0;2;172;;1;;71;2
BIZKAIA;74;URDUÑA/ORDUÑA;2;1;A;639;451;2;449;2;447;188;180;31;0;0;25;0;0;2;0;0;155;;3;;51;0
BIZKAIA;74;URDUÑA/ORDUÑA;2;1;B;817;575;3;572;2;570;242;269;32;0;0;34;2;4;4;0;0;153;;4;;66;2
BIZKAIA;75;OROZKO;1;1;A;804;569;3;566;7;559;235;318;19;0;0;11;6;0;5;1;0;151;;0;;48;0
BIZKAIA;75;OROZKO;1;1;B;915;649;4;645;6;639;266;345;29;1;0;17;1;1;8;3;0;154;;3;;75;2
BIZKAIA;75;OROZKO;1;1;C;301;181;2;179;1;178;120;79;5;0;0;4;1;0;0;0;0;62;;0;;27;0
BIZKAIA;76;SUKARRIETA;1;1;U;311;234;1;233;2;231;77;149;7;0;1;4;0;0;1;0;0;56;;0;;13;0
BIZKAIA;77;PLENTZIA;1;1;A;767;515;1;514;2;512;252;268;34;0;0;20;9;0;10;0;1;111;;4;;55;0
BIZKAIA;77;PLENTZIA;1;1;B;722;479;0;479;1;478;243;223;30;0;0;32;0;0;12;1;0;113;;1;;65;1
BIZKAIA;77;PLENTZIA;1;2;A;685;523;2;521;2;519;162;269;29;0;0;23;2;1;7;2;0;118;;6;;61;1
BIZKAIA;77;PLENTZIA;1;2;B;622;430;0;430;1;429;192;221;25;1;0;21;2;0;5;1;0;97;;2;;53;1
BIZKAIA;77;PLENTZIA;1;2;C;571;416;0;416;1;415;155;235;21;0;0;19;2;1;2;0;0;89;;2;;44;0
BIZKAIA;78;PORTUGALETE;1;1;U;794;513;1;512;5;507;281;206;44;0;1;61;6;0;4;1;1;115;;0;;68;0
BIZKAIA;78;PORTUGALETE;1;2;U;928;660;2;658;6;652;268;286;111;1;1;61;6;1;17;0;0;102;;2;;64;0
BIZKAIA;78;PORTUGALETE;1;3;A;526;377;1;376;2;374;149;194;41;0;0;40;5;1;9;1;0;49;;1;;33;0
BIZKAIA;78;PORTUGALETE;1;3;B;522;381;4;377;0;377;141;164;39;1;0;39;1;0;8;1;0;52;;2;;70;0
BIZKAIA;78;PORTUGALETE;1;4;U;720;456;1;455;3;452;264;172;41;0;2;81;6;1;13;1;0;50;;3;;82;0
BIZKAIA;78;PORTUGALETE;1;5;U;553;330;2;328;0;328;223;121;25;0;0;80;1;0;4;1;0;31;;2;;63;0
BIZKAIA;78;PORTUGALETE;1;6;A;620;407;1;406;1;405;213;176;49;1;0;66;2;0;8;1;0;41;;6;;53;2
BIZKAIA;78;PORTUGALETE;1;6;B;663;469;4;465;11;454;194;198;62;1;1;75;0;0;9;0;0;52;;5;;50;1
BIZKAIA;78;PORTUGALETE;1;7;U;615;391;1;390;5;385;224;151;30;0;1;67;3;4;10;2;0;61;;2;;53;1
BIZKAIA;78;PORTUGALETE;1;8;A;460;271;0;271;0;271;189;80;24;0;0;61;1;0;5;0;0;26;;5;;69;0
BIZKAIA;78;PORTUGALETE;1;8;B;503;302;1;301;2;299;201;91;29;0;0;68;2;0;8;1;0;28;;3;;69;0
BIZKAIA;78;PORTUGALETE;1;9;A;790;537;0;537;1;536;253;189;97;0;1;99;1;0;14;0;0;56;;3;;76;0
BIZKAIA;78;PORTUGALETE;1;9;B;940;638;2;636;4;632;302;263;100;0;1;93;1;0;13;1;0;48;;2;;109;1
BIZKAIA;78;PORTUGALETE;2;1;A;503;279;1;278;2;276;224;88;26;0;0;58;0;1;6;0;0;39;;3;;54;1
BIZKAIA;78;PORTUGALETE;2;1;B;520;294;1;293;4;289;226;96;24;0;0;50;3;2;10;1;0;38;;2;;63;0
BIZKAIA;78;PORTUGALETE;2;2;U;714;425;1;424;3;421;289;147;37;0;1;100;2;1;8;0;0;46;;1;;76;2
BIZKAIA;78;PORTUGALETE;2;3;U;828;512;4;508;1;507;316;176;63;0;5;111;5;1;6;0;0;41;;10;;86;3
BIZKAIA;78;PORTUGALETE;2;4;U;661;424;3;421;1;420;237;149;31;1;1;79;1;1;2;1;0;63;;1;;90;0
BIZKAIA;78;PORTUGALETE;2;5;U;661;369;2;367;1;366;292;105;38;0;0;100;5;1;4;1;1;40;;3;;65;3
BIZKAIA;78;PORTUGALETE;2;6;A;560;362;3;359;0;359;198;106;29;0;1;97;6;0;11;1;0;36;;1;;71;0
BIZKAIA;78;PORTUGALETE;2;6;B;620;352;1;351;1;350;268;122;26;1;0;80;7;0;10;0;0;48;;2;;53;1
BIZKAIA;78;PORTUGALETE;2;7;U;547;340;1;339;1;338;207;102;29;0;0;113;3;0;3;0;0;39;;0;;47;2
BIZKAIA;78;PORTUGALETE;2;8;A;492;267;1;266;1;265;225;83;17;0;0;73;2;1;8;1;0;28;;1;;51;0
BIZKAIA;78;PORTUGALETE;2;8;B;557;299;0;299;0;299;258;93;26;0;2;79;4;0;10;1;0;28;;1;;55;0
BIZKAIA;78;PORTUGALETE;2;9;U;633;378;1;377;1;376;255;106;67;0;0;104;1;1;10;0;0;26;;1;;60;0
BIZKAIA;78;PORTUGALETE;2;10;A;534;348;2;346;2;344;186;136;21;1;0;61;5;0;2;1;0;34;;2;;80;1
BIZKAIA;78;PORTUGALETE;2;10;B;627;412;1;411;2;409;215;137;25;0;1;75;2;1;8;1;0;40;;5;;111;3
BIZKAIA;78;PORTUGALETE;3;1;U;747;454;0;454;1;453;293;171;40;0;0;71;5;1;4;0;1;87;;2;;71;0
BIZKAIA;78;PORTUGALETE;3;2;U;591;353;2;351;1;350;238;150;19;0;0;51;1;0;11;0;0;49;;0;;69;0
BIZKAIA;78;PORTUGALETE;3;3;A;543;326;1;325;5;320;217;108;42;0;0;79;4;2;6;0;0;33;;1;;45;0
BIZKAIA;78;PORTUGALETE;3;3;B;519;302;3;299;1;298;217;100;27;0;0;69;1;1;7;0;0;36;;1;;56;0
BIZKAIA;78;PORTUGALETE;3;4;U;745;416;1;415;2;413;329;123;23;0;1;97;4;2;6;1;0;61;;3;;92;0
BIZKAIA;78;PORTUGALETE;3;5;U;853;518;1;517;8;509;335;183;46;0;0;95;0;0;6;0;0;66;;2;;111;0
BIZKAIA;78;PORTUGALETE;3;6;U;810;488;9;479;5;474;322;159;43;1;0;74;1;0;6;0;0;74;;3;;112;1
BIZKAIA;78;PORTUGALETE;3;7;U;912;478;2;476;1;475;434;152;49;1;2;136;1;0;3;0;0;32;;5;;94;0
BIZKAIA;78;PORTUGALETE;3;8;A;512;252;0;252;2;250;260;84;30;0;0;67;3;1;5;0;0;16;;1;;42;1
BIZKAIA;78;PORTUGALETE;3;8;B;510;282;3;279;4;275;228;85;37;0;0;72;1;1;6;0;0;20;;3;;50;0
BIZKAIA;78;PORTUGALETE;3;9;A;485;269;1;268;2;266;216;112;31;0;0;36;3;0;5;0;0;33;;1;;45;0
BIZKAIA;78;PORTUGALETE;3;9;B;532;298;2;296;4;292;234;115;29;0;0;53;3;1;5;0;0;38;;2;;46;0
BIZKAIA;78;PORTUGALETE;3;10;U;669;358;3;355;0;355;311;101;29;0;0;94;0;1;5;0;0;30;;4;;88;3
BIZKAIA;78;PORTUGALETE;3;11;U;763;461;0;461;0;461;302;170;55;0;1;91;6;2;13;0;0;59;;2;;62;0
BIZKAIA;78;PORTUGALETE;3;12;A;626;423;1;422;1;421;203;147;63;0;0;77;3;1;16;0;0;56;;2;;56;0
BIZKAIA;78;PORTUGALETE;3;12;B;744;488;2;486;4;482;256;176;51;0;0;106;3;1;12;1;0;51;;4;;77;0
BIZKAIA;78;PORTUGALETE;4;1;U;820;503;2;501;0;501;317;170;65;0;1;107;3;0;13;0;0;63;;1;;75;3
BIZKAIA;78;PORTUGALETE;4;2;U;803;447;3;444;4;440;356;141;43;1;4;94;3;0;4;1;0;39;;3;;105;2
BIZKAIA;78;PORTUGALETE;4;3;A;626;390;2;388;2;386;236;122;20;0;2;83;7;0;6;0;0;45;;11;;89;1
BIZKAIA;78;PORTUGALETE;4;3;B;677;429;3;426;2;424;248;125;34;1;4;100;5;0;12;0;0;34;;5;;102;2
BIZKAIA;78;PORTUGALETE;4;4;A;472;297;1;296;0;296;175;66;33;0;0;89;4;0;3;1;0;35;;2;;63;0
BIZKAIA;78;PORTUGALETE;4;4;B;486;305;1;304;2;302;181;86;37;0;0;90;4;1;6;1;0;17;;1;;58;1
BIZKAIA;78;PORTUGALETE;4;5;A;603;363;0;363;5;358;240;118;26;0;0;93;7;0;7;0;0;35;;2;;70;0
BIZKAIA;78;PORTUGALETE;4;5;B;671;439;2;437;1;436;232;139;32;0;1;123;6;1;9;1;0;48;;7;;68;1
BIZKAIA;78;PORTUGALETE;4;6;U;949;530;3;527;3;524;419;143;53;1;2;144;6;1;8;2;1;48;;5;;109;1
BIZKAIA;78;PORTUGALETE;4;7;A;542;280;1;279;3;276;262;85;17;0;1;82;2;0;3;0;0;30;;2;;54;0
BIZKAIA;78;PORTUGALETE;4;7;B;540;275;2;273;4;269;265;89;20;0;1;70;3;0;3;0;0;16;;5;;61;1
BIZKAIA;78;PORTUGALETE;5;1;A;611;380;0;380;1;379;231;140;21;0;1;73;4;0;6;1;0;48;;2;;82;1
BIZKAIA;78;PORTUGALETE;5;1;B;661;362;4;358;2;356;299;112;20;0;1;67;8;3;5;0;0;35;;6;;98;1
BIZKAIA;78;PORTUGALETE;5;1;C;655;370;2;368;2;366;285;127;27;0;0;80;3;2;6;0;0;31;;2;;88;0
BIZKAIA;78;PORTUGALETE;5;2;A;826;439;4;435;1;434;387;136;28;0;2;87;5;2;9;0;0;67;;2;;96;0
BIZKAIA;78;PORTUGALETE;5;2;B;881;490;4;486;2;484;391;136;45;1;3;87;2;1;15;1;0;65;;6;;122;0
BIZKAIA;79;ERRIGOITI;1;1;U;426;326;1;325;3;322;100;139;5;0;0;3;1;0;1;0;0;138;;0;;35;0
BIZKAIA;80;VALLE DE TRÁPAGA-TRAPAGARAN;1;1;A;564;387;4;383;2;381;177;146;25;0;1;71;4;0;9;0;0;53;;2;;69;1
BIZKAIA;80;VALLE DE TRÁPAGA-TRAPAGARAN;1;1;B;675;422;3;419;4;415;253;154;24;1;0;80;5;0;12;1;0;54;;2;;81;1
BIZKAIA;80;VALLE DE TRÁPAGA-TRAPAGARAN;1;2;U;900;539;1;538;2;536;361;191;18;0;0;85;3;1;5;1;0;105;;6;;121;0
BIZKAIA;80;VALLE DE TRÁPAGA-TRAPAGARAN;1;3;U;819;515;8;507;5;502;304;199;30;0;0;111;4;0;10;0;0;55;;1;;91;1
BIZKAIA;80;VALLE DE TRÁPAGA-TRAPAGARAN;1;4;U;916;558;4;554;2;552;358;242;41;0;1;72;2;0;4;0;0;83;;2;;104;1
BIZKAIA;80;VALLE DE TRÁPAGA-TRAPAGARAN;1;5;U;512;294;0;294;0;294;218;101;10;0;0;53;4;0;3;0;0;51;;2;;70;0
BIZKAIA;80;VALLE DE TRÁPAGA-TRAPAGARAN;1;6;A;559;343;4;339;4;335;216;166;19;0;0;35;1;0;6;0;0;46;;3;;58;1
BIZKAIA;80;VALLE DE TRÁPAGA-TRAPAGARAN;1;6;B;262;122;0;122;1;121;140;37;7;0;0;20;2;0;1;0;0;23;;0;;31;0
BIZKAIA;80;VALLE DE TRÁPAGA-TRAPAGARAN;1;7;U;808;510;1;509;2;507;298;194;24;0;0;85;2;1;17;1;0;52;;2;;128;1
BIZKAIA;80;VALLE DE TRÁPAGA-TRAPAGARAN;1;8;U;875;545;4;541;3;538;330;208;40;0;0;96;3;0;5;1;0;86;;2;;97;0
BIZKAIA;80;VALLE DE TRÁPAGA-TRAPAGARAN;1;9;A;621;392;5;387;2;385;229;120;17;0;0;73;3;0;3;0;1;78;;2;;88;0
BIZKAIA;80;VALLE DE TRÁPAGA-TRAPAGARAN;1;9;B;638;384;2;382;0;382;254;146;21;1;0;63;1;0;0;1;0;76;;1;;72;0
BIZKAIA;80;VALLE DE TRÁPAGA-TRAPAGARAN;1;10;A;567;373;2;371;1;370;194;152;17;1;1;71;3;0;4;0;0;47;;1;;72;1
BIZKAIA;80;VALLE DE TRÁPAGA-TRAPAGARAN;1;10;B;573;386;5;381;2;379;187;179;15;0;0;62;5;0;6;0;0;49;;0;;63;0
BIZKAIA;80;VALLE DE TRÁPAGA-TRAPAGARAN;2;1;A;245;164;0;164;0;164;81;52;12;0;1;20;1;0;2;0;0;52;;1;;22;1
BIZKAIA;80;VALLE DE TRÁPAGA-TRAPAGARAN;2;1;B;434;267;5;262;0;262;167;80;8;0;1;62;3;0;2;1;0;67;;0;;38;0
BIZKAIA;81;LEZAMA;1;1;A;787;575;2;573;2;571;212;334;14;0;0;17;2;0;0;0;0;146;;4;;54;0
BIZKAIA;81;LEZAMA;1;1;B;559;397;5;392;3;389;162;204;12;0;0;8;1;1;6;1;1;117;;5;;33;0
BIZKAIA;81;LEZAMA;1;1;C;524;398;3;395;2;393;126;207;17;0;0;18;3;1;0;0;0;113;;0;;34;0
BIZKAIA;82;SANTURTZI;1;1;A;544;380;3;377;7;370;164;183;54;0;0;41;1;0;4;2;0;29;;3;;53;0
BIZKAIA;82;SANTURTZI;1;1;B;580;379;0;379;1;378;201;177;65;0;0;38;2;0;4;0;0;36;;3;;52;1
BIZKAIA;82;SANTURTZI;1;2;A;496;314;3;311;1;310;182;133;22;0;0;49;6;1;4;0;0;38;;5;;51;1
BIZKAIA;82;SANTURTZI;1;2;B;513;342;0;342;1;341;171;141;22;0;0;53;2;0;3;0;0;45;;4;;69;2
BIZKAIA;82;SANTURTZI;1;3;U;953;549;4;545;3;542;404;196;42;0;0;93;3;1;5;1;0;73;;4;;123;1
BIZKAIA;82;SANTURTZI;1;4;A;516;312;1;311;5;306;204;119;16;1;0;50;1;2;1;0;0;59;;0;;57;0
BIZKAIA;82;SANTURTZI;1;4;B;572;335;2;333;3;330;237;140;13;0;3;51;2;2;5;0;0;48;;2;;64;0
BIZKAIA;82;SANTURTZI;1;5;A;599;377;2;375;1;374;222;171;34;0;0;58;3;0;8;0;0;55;;2;;43;0
BIZKAIA;82;SANTURTZI;1;5;B;575;356;1;355;2;353;219;159;41;0;0;40;4;0;8;0;0;47;;3;;49;2
BIZKAIA;82;SANTURTZI;1;6;A;677;438;0;438;1;437;239;193;39;0;2;50;6;0;10;0;0;74;;4;;57;2
BIZKAIA;82;SANTURTZI;1;6;B;742;475;1;474;1;473;267;189;46;0;1;57;9;1;7;1;0;77;;4;;81;0
BIZKAIA;82;SANTURTZI;1;7;A;524;306;0;306;0;306;218;124;19;0;1;48;1;0;6;0;0;53;;1;;53;0
BIZKAIA;82;SANTURTZI;1;7;B;568;316;0;316;1;315;252;109;20;1;0;58;3;0;5;0;0;50;;0;;69;0
BIZKAIA;82;SANTURTZI;1;8;U;527;318;2;316;1;315;209;108;22;0;1;53;0;0;7;0;0;68;;2;;54;0
BIZKAIA;82;SANTURTZI;1;9;A;689;437;2;435;3;432;252;167;37;1;2;64;6;0;5;0;0;53;;4;;93;0
BIZKAIA;82;SANTURTZI;1;9;B;622;381;1;380;3;377;241;145;27;0;0;59;3;0;4;0;1;54;;4;;80;0
BIZKAIA;82;SANTURTZI;1;10;A;531;308;2;306;1;305;223;101;16;0;1;47;3;0;6;0;0;54;;2;;74;1
BIZKAIA;82;SANTURTZI;1;10;B;552;320;0;320;3;317;232;111;24;0;2;56;8;0;4;0;0;38;;0;;74;0
BIZKAIA;82;SANTURTZI;1;11;A;592;309;0;309;2;307;283;111;20;0;0;46;1;0;4;0;0;45;;7;;71;2
BIZKAIA;82;SANTURTZI;1;11;B;596;329;4;325;0;325;267;108;23;0;1;55;2;0;4;0;0;43;;4;;85;0
BIZKAIA;82;SANTURTZI;1;12;A;490;271;0;271;0;271;219;102;7;1;0;27;5;1;5;0;0;66;;2;;55;0
BIZKAIA;82;SANTURTZI;1;12;B;497;292;0;292;2;290;205;104;9;0;1;53;4;0;4;0;0;45;;6;;64;0
BIZKAIA;82;SANTURTZI;1;13;U;595;356;3;353;0;353;239;118;15;0;1;37;2;0;4;1;0;104;;5;;66;0
BIZKAIA;82;SANTURTZI;1;14;A;591;351;1;350;5;345;240;132;18;2;1;29;3;1;6;0;0;75;;3;;74;1
BIZKAIA;82;SANTURTZI;1;14;B;589;372;1;371;1;370;217;140;19;1;2;40;3;1;3;0;0;82;;4;;73;2
BIZKAIA;82;SANTURTZI;1;16;A;494;311;0;311;2;309;183;111;16;0;0;42;1;0;5;2;0;65;;5;;61;1
BIZKAIA;82;SANTURTZI;1;16;B;484;308;3;305;0;305;176;81;24;0;2;57;1;0;6;0;1;88;;1;;42;2
BIZKAIA;82;SANTURTZI;1;17;U;715;441;1;440;3;437;274;181;40;0;0;98;3;0;12;0;0;30;;5;;68;0
BIZKAIA;82;SANTURTZI;1;18;U;768;452;2;450;2;448;316;142;14;0;0;54;6;1;5;1;1;131;;7;;86;0
BIZKAIA;82;SANTURTZI;2;1;U;886;463;1;462;1;461;423;170;22;0;0;81;4;0;4;3;0;59;;3;;113;2
BIZKAIA;82;SANTURTZI;2;3;A;553;331;1;330;2;328;222;142;13;0;0;61;5;0;4;0;0;39;;3;;61;0
BIZKAIA;82;SANTURTZI;2;3;B;559;336;0;336;1;335;223;136;22;1;0;56;4;1;10;0;0;41;;2;;61;1
BIZKAIA;82;SANTURTZI;2;4;U;648;318;2;316;2;314;330;90;23;0;0;65;1;1;5;0;0;40;;3;;85;1
BIZKAIA;82;SANTURTZI;2;5;A;569;358;0;358;3;355;211;162;35;0;1;37;1;0;15;1;0;50;;2;;49;2
BIZKAIA;82;SANTURTZI;2;5;B;687;463;0;463;2;461;224;218;49;0;0;57;4;0;9;0;0;50;;4;;68;2
BIZKAIA;82;SANTURTZI;2;6;U;893;564;3;561;5;556;329;245;57;1;1;73;4;0;5;1;0;84;;5;;80;0
BIZKAIA;82;SANTURTZI;2;7;U;903;569;4;565;2;563;334;264;57;0;1;63;4;1;6;0;0;103;;2;;62;0
BIZKAIA;82;SANTURTZI;2;8;A;493;331;0;331;4;327;162;166;39;1;0;39;0;0;10;0;0;42;;0;;29;1
BIZKAIA;82;SANTURTZI;2;8;B;527;344;2;342;0;342;183;143;50;0;0;48;6;1;9;0;0;34;;1;;50;0
BIZKAIA;82;SANTURTZI;3;1;A;491;284;3;281;2;279;207;137;21;0;0;28;3;0;4;0;0;29;;1;;54;2
BIZKAIA;82;SANTURTZI;3;1;B;489;304;1;303;0;303;185;146;29;0;0;48;5;0;3;0;1;27;;2;;42;0
BIZKAIA;82;SANTURTZI;3;2;U;696;389;2;387;4;383;307;156;19;0;0;75;0;0;1;1;1;50;;6;;74;0
BIZKAIA;82;SANTURTZI;3;3;A;648;412;2;410;3;407;236;156;50;1;0;57;4;1;9;2;0;34;;7;;85;1
BIZKAIA;82;SANTURTZI;3;3;B;638;402;2;400;3;397;236;151;37;0;2;60;3;0;7;0;0;45;;15;;74;3
BIZKAIA;82;SANTURTZI;3;4;A;552;347;3;344;2;342;205;137;31;0;0;65;0;0;6;1;0;37;;5;;60;0
BIZKAIA;82;SANTURTZI;3;4;B;558;364;2;362;5;357;194;129;25;0;0;67;1;1;3;1;0;43;;7;;79;1
BIZKAIA;82;SANTURTZI;3;5;A;558;336;0;336;2;334;222;106;26;0;0;62;4;1;7;0;0;47;;4;;75;2
BIZKAIA;82;SANTURTZI;3;5;B;624;375;1;374;2;372;249;126;25;0;0;78;8;0;11;0;0;47;;3;;73;1
BIZKAIA;82;SANTURTZI;3;6;U;907;576;6;570;2;568;331;204;36;2;0;126;4;0;7;1;0;45;;3;;139;1
BIZKAIA;82;SANTURTZI;3;7;U;693;401;1;400;1;399;292;175;28;0;0;74;2;1;9;0;0;34;;2;;74;0
BIZKAIA;82;SANTURTZI;3;8;U;874;549;4;545;7;538;325;198;45;0;1;89;2;0;21;2;0;55;;2;;119;4
BIZKAIA;82;SANTURTZI;4;1;U;832;492;3;489;1;488;340;180;15;1;0;90;3;0;11;0;0;67;;11;;109;1
BIZKAIA;82;SANTURTZI;4;2;U;581;294;1;293;1;292;287;88;21;0;0;50;1;1;5;0;0;38;;10;;77;1
BIZKAIA;82;SANTURTZI;4;3;A;690;404;2;402;3;399;286;142;14;0;0;59;6;1;8;2;0;80;;1;;86;0
BIZKAIA;82;SANTURTZI;4;3;B;727;396;3;393;5;388;331;140;29;0;0;50;3;0;9;1;0;82;;1;;72;1
BIZKAIA;82;SANTURTZI;4;4;U;896;546;1;545;8;537;350;189;31;0;1;79;4;3;12;1;0;87;;6;;121;3
BIZKAIA;82;SANTURTZI;4;5;A;497;286;2;284;0;284;211;136;15;0;1;40;2;2;3;0;0;37;;5;;42;1
BIZKAIA;82;SANTURTZI;4;5;B;558;348;1;347;0;347;210;127;19;0;1;66;1;1;12;0;0;45;;5;;70;0
BIZKAIA;82;SANTURTZI;5;1;A;497;209;1;208;1;207;288;85;4;0;0;40;6;0;3;1;0;33;;3;;32;0
BIZKAIA;82;SANTURTZI;5;1;B;576;261;2;259;2;257;315;82;16;0;0;53;1;0;4;0;0;46;;1;;54;0
BIZKAIA;83;ORTUELLA;1;1;U;942;555;1;554;3;551;387;184;28;0;1;101;6;0;3;0;0;68;;1;;159;0
BIZKAIA;83;ORTUELLA;1;2;A;674;431;2;429;5;424;243;144;10;0;0;57;5;1;4;0;0;71;;2;;130;0
BIZKAIA;83;ORTUELLA;1;2;B;811;492;4;488;4;484;319;165;13;0;1;111;4;1;3;0;0;50;;5;;129;2
BIZKAIA;83;ORTUELLA;1;3;U;725;417;2;415;1;414;308;159;15;0;2;69;2;0;2;0;0;55;;2;;108;0
BIZKAIA;83;ORTUELLA;1;4;A;658;405;1;404;2;402;253;144;13;0;0;73;3;2;5;0;1;47;;3;;109;2
BIZKAIA;83;ORTUELLA;1;4;B;798;512;0;512;4;508;286;186;15;0;1;82;8;0;11;0;0;86;;2;;116;1
BIZKAIA;83;ORTUELLA;1;5;A;677;454;5;449;5;444;223;171;18;1;0;57;1;1;3;0;0;64;;1;;127;0
BIZKAIA;83;ORTUELLA;1;5;B;730;484;4;480;3;477;246;185;18;2;0;86;4;1;5;0;0;60;;1;;114;1
BIZKAIA;83;ORTUELLA;2;1;A;719;488;2;486;6;480;231;194;15;1;1;65;6;2;2;1;0;85;;4;;103;1
BIZKAIA;83;ORTUELLA;2;1;B;213;157;1;156;1;155;56;74;9;0;0;17;1;0;1;0;0;23;;2;;28;0
BIZKAIA;84;SESTAO;1;1;A;607;388;0;388;0;388;219;142;26;0;2;68;2;0;1;0;0;62;;2;;80;3
BIZKAIA;84;SESTAO;1;1;B;662;432;1;431;4;427;230;169;30;0;0;73;3;2;6;0;0;61;;6;;77;0
BIZKAIA;84;SESTAO;1;2;A;518;298;4;294;1;293;220;114;17;0;0;46;3;0;9;0;0;46;;2;;56;0
BIZKAIA;84;SESTAO;1;2;B;587;329;3;326;3;323;258;129;20;0;0;59;6;0;2;0;0;32;;1;;74;0
BIZKAIA;84;SESTAO;1;3;A;568;348;2;346;2;344;220;138;49;1;0;53;2;0;6;2;0;40;;2;;51;0
BIZKAIA;84;SESTAO;1;3;B;596;388;1;387;3;384;208;148;56;0;0;63;4;1;7;0;2;35;;5;;63;0
BIZKAIA;84;SESTAO;1;4;A;494;290;4;286;6;280;204;112;23;0;0;57;2;0;7;0;0;29;;2;;46;2
BIZKAIA;84;SESTAO;1;4;B;571;325;2;323;4;319;246;123;36;0;1;66;3;1;1;1;0;31;;1;;54;1
BIZKAIA;84;SESTAO;1;5;U;576;358;3;355;0;355;218;147;35;0;0;47;4;0;6;1;0;47;;1;;67;0
BIZKAIA;84;SESTAO;1;6;A;485;255;2;253;3;250;230;103;26;1;0;41;2;1;4;0;0;21;;5;;46;0
BIZKAIA;84;SESTAO;1;6;B;516;305;2;303;4;299;211;122;34;0;1;59;6;0;4;0;0;21;;1;;50;1
BIZKAIA;84;SESTAO;1;7;A;465;289;1;288;0;288;176;112;25;0;0;56;2;0;5;0;0;34;;1;;52;1
BIZKAIA;84;SESTAO;1;7;B;488;298;0;298;0;298;190;114;16;0;0;65;1;0;1;1;0;27;;4;;68;1
BIZKAIA;84;SESTAO;1;8;U;761;438;3;435;0;435;323;163;61;0;0;89;2;0;9;0;2;40;;3;;66;0
BIZKAIA;84;SESTAO;2;1;U;809;437;3;434;4;430;372;169;32;0;1;62;1;0;6;1;1;63;;2;;90;2
BIZKAIA;84;SESTAO;2;2;U;852;490;1;489;7;482;362;180;17;0;0;68;0;1;6;0;1;82;;7;;117;3
BIZKAIA;84;SESTAO;2;3;U;852;557;8;549;4;545;295;241;36;0;1;83;0;0;11;2;0;76;;5;;89;1
BIZKAIA;84;SESTAO;2;4;U;905;558;3;555;5;550;347;221;15;0;0;83;4;4;6;1;0;89;;5;;122;0
BIZKAIA;84;SESTAO;2;5;U;826;488;2;486;7;479;338;191;47;0;1;70;7;1;10;1;0;52;;6;;93;0
BIZKAIA;84;SESTAO;2;6;U;606;311;1;310;1;309;295;128;37;0;0;77;3;0;4;2;0;30;;4;;24;0
BIZKAIA;84;SESTAO;3;1;U;656;386;5;381;3;378;270;162;27;0;1;47;2;0;3;0;0;41;;10;;83;2
BIZKAIA;84;SESTAO;3;2;A;459;216;0;216;3;213;243;87;8;1;0;23;4;1;2;1;0;30;;4;;52;0
BIZKAIA;84;SESTAO;3;2;B;482;258;0;258;1;257;224;109;11;0;0;24;5;0;2;0;0;40;;4;;62;0
BIZKAIA;84;SESTAO;3;3;U;697;390;0;390;2;388;307;133;34;0;0;73;4;0;5;0;1;60;;4;;74;0
BIZKAIA;84;SESTAO;3;4;U;795;413;2;411;2;409;382;178;21;0;1;76;2;0;4;1;1;45;;3;;77;0
BIZKAIA;84;SESTAO;3;5;U;603;298;1;297;5;292;305;107;15;0;0;44;3;0;5;1;0;41;;7;;69;0
BIZKAIA;84;SESTAO;3;6;U;584;357;0;357;2;355;227;154;18;0;0;54;1;0;2;1;0;60;;3;;62;0
BIZKAIA;84;SESTAO;4;1;A;440;256;5;251;4;247;184;88;15;0;2;50;0;1;6;0;0;32;;3;;48;2
BIZKAIA;84;SESTAO;4;1;B;490;298;3;295;1;294;192;111;21;0;1;53;3;0;6;0;0;23;;4;;68;4
BIZKAIA;84;SESTAO;4;2;A;430;235;3;232;0;232;195;73;29;0;0;65;1;1;2;1;0;28;;1;;31;0
BIZKAIA;84;SESTAO;4;2;B;531;317;6;311;2;309;214;114;27;0;0;79;2;0;3;1;0;26;;2;;55;0
BIZKAIA;84;SESTAO;4;3;U;717;401;2;399;0;399;316;166;25;0;0;71;3;0;7;1;1;35;;3;;86;1
BIZKAIA;84;SESTAO;4;4;U;919;475;2;473;2;471;444;187;12;1;1;68;7;2;7;2;1;55;;4;;122;2
BIZKAIA;84;SESTAO;4;5;U;737;355;3;352;0;352;382;137;32;0;0;73;4;0;4;0;0;23;;2;;76;1
BIZKAIA;84;SESTAO;4;6;A;569;271;2;269;0;269;298;88;18;0;0;59;6;1;7;0;1;32;;1;;56;0
BIZKAIA;84;SESTAO;4;6;B;506;251;0;251;0;251;255;91;26;1;0;40;3;0;1;2;0;30;;1;;54;2
BIZKAIA;85;SOPELA;1;1;A;585;397;5;392;2;390;188;170;19;0;2;21;2;0;3;0;0;100;;2;;71;0
BIZKAIA;85;SOPELA;1;1;B;550;368;2;366;3;363;182;143;16;1;0;23;4;0;6;0;0;100;;2;;67;1
BIZKAIA;85;SOPELA;1;2;A;900;588;3;585;4;581;312;248;18;0;0;45;10;3;5;4;1;140;;3;;100;4
BIZKAIA;85;SOPELA;1;2;B;867;532;1;531;3;528;335;237;22;0;0;41;5;1;2;1;2;124;;7;;84;2
BIZKAIA;85;SOPELA;1;3;A;758;477;4;473;2;471;281;195;16;0;2;41;5;0;12;0;0;125;;1;;74;0
BIZKAIA;85;SOPELA;1;3;B;718;478;2;476;3;473;240;182;26;0;0;55;3;3;10;1;1;104;;2;;85;1
BIZKAIA;85;SOPELA;1;4;A;926;596;2;594;4;590;330;272;40;0;0;36;3;1;12;0;0;143;;8;;74;1
BIZKAIA;85;SOPELA;1;4;B;823;485;3;482;4;478;338;200;21;0;1;41;4;0;4;1;0;131;;1;;73;1
BIZKAIA;85;SOPELA;1;5;A;538;340;0;340;2;338;198;142;7;0;0;19;3;0;8;1;0;99;;2;;56;1
BIZKAIA;85;SOPELA;1;5;B;518;336;0;336;0;336;182;138;9;0;0;14;6;0;10;0;0;96;;0;;61;2
BIZKAIA;85;SOPELA;1;6;A;781;514;4;510;0;510;267;212;31;0;0;24;8;1;9;0;1;138;;6;;80;0
BIZKAIA;85;SOPELA;1;6;B;659;455;2;453;2;451;204;207;13;0;1;19;2;0;4;1;0;122;;2;;78;2
BIZKAIA;85;SOPELA;1;7;A;920;588;2;586;3;583;332;273;29;0;0;17;9;1;13;0;1;146;;1;;93;0
BIZKAIA;85;SOPELA;1;7;B;812;532;2;530;2;528;280;232;33;0;2;25;5;0;5;0;0;125;;1;;97;3
BIZKAIA;86;SOPUERTA;1;1;A;504;347;1;346;2;344;157;171;11;0;0;21;4;1;5;0;0;86;;2;;42;1
BIZKAIA;86;SOPUERTA;1;1;B;556;367;4;363;4;359;189;170;10;0;0;10;1;0;3;0;0;97;;0;;68;0
BIZKAIA;86;SOPUERTA;1;2;A;519;318;7;311;3;308;201;146;14;1;1;30;2;1;2;0;0;58;;1;;50;2
BIZKAIA;86;SOPUERTA;1;2;B;482;307;0;307;0;307;175;153;6;0;0;26;1;2;4;0;0;56;;1;;58;0
BIZKAIA;87;TRUCIOS-TURTZIOZ;1;1;U;430;335;3;332;1;331;95;211;27;0;0;14;1;1;1;1;0;46;;4;;25;0
BIZKAIA;88;UBIDE;1;1;U;137;102;0;102;0;102;35;27;2;0;0;0;1;1;0;0;0;57;;0;;14;0
BIZKAIA;89;URDULIZ;1;1;A;723;476;2;474;4;470;247;236;21;2;1;32;8;1;8;0;0;99;;0;;61;1
BIZKAIA;89;URDULIZ;1;1;B;691;446;1;445;1;444;245;202;16;0;0;30;4;0;15;1;1;102;;0;;72;1
BIZKAIA;89;URDULIZ;1;1;C;662;444;3;441;5;436;218;204;15;0;1;37;5;0;6;0;0;95;;1;;71;1
BIZKAIA;89;URDULIZ;1;2;A;674;449;3;446;4;442;225;222;11;0;0;15;5;0;2;0;0;118;;3;;65;1
BIZKAIA;89;URDULIZ;1;2;B;560;360;0;360;2;358;200;201;15;0;0;14;2;0;2;1;0;78;;3;;41;1
BIZKAIA;90;BALMASEDA;1;1;A;560;392;5;387;1;386;168;194;14;0;0;41;2;0;3;0;0;58;;3;;71;0
BIZKAIA;90;BALMASEDA;1;1;B;675;471;3;468;4;464;204;245;25;0;1;60;2;0;3;1;0;69;;1;;57;0
BIZKAIA;90;BALMASEDA;1;2;U;633;434;11;423;0;423;199;205;20;0;0;39;2;3;2;1;0;85;;3;;63;0
BIZKAIA;90;BALMASEDA;1;3;U;546;353;2;351;5;346;193;169;24;1;0;53;4;3;4;0;0;46;;2;;40;0
BIZKAIA;90;BALMASEDA;1;4;U;809;579;10;569;5;564;230;262;38;0;0;89;2;3;7;0;1;86;;5;;71;0
BIZKAIA;90;BALMASEDA;2;1;A;645;448;4;444;2;442;197;228;30;0;1;53;1;0;4;0;0;65;;4;;54;2
BIZKAIA;90;BALMASEDA;2;1;B;822;587;5;582;5;577;235;295;29;0;1;62;1;2;13;2;0;81;;5;;85;1
BIZKAIA;90;BALMASEDA;2;2;A;605;380;8;372;4;368;225;198;14;0;0;53;1;3;4;2;0;44;;2;;46;1
BIZKAIA;90;BALMASEDA;2;2;B;709;494;10;484;0;484;215;241;21;0;1;67;2;2;8;0;0;69;;5;;67;1
BIZKAIA;91;ATXONDO;1;1;A;835;544;5;539;6;533;291;232;14;0;0;27;4;1;4;0;0;194;;6;;50;1
BIZKAIA;91;ATXONDO;1;1;B;276;216;0;216;4;212;60;93;1;0;0;2;1;0;1;0;0;103;;0;;11;0
BIZKAIA;92;BEDIA;1;1;U;840;572;0;572;8;564;268;323;27;1;0;22;2;5;2;0;0;120;;4;;57;1
BIZKAIA;93;AREATZA;1;1;U;890;666;5;661;2;659;224;294;32;0;0;14;1;0;6;0;0;268;;3;;38;3
BIZKAIA;94;IGORRE;1;1;A;627;461;1;460;2;458;166;238;16;0;0;14;0;0;2;1;1;148;;2;;35;1
BIZKAIA;94;IGORRE;1;1;B;468;341;2;339;1;338;127;168;8;0;0;5;0;0;3;1;0;128;;0;;25;0
BIZKAIA;94;IGORRE;1;2;A;773;518;3;515;3;512;255;225;5;2;0;9;3;1;3;0;1;212;;1;;50;0
BIZKAIA;94;IGORRE;1;2;B;514;352;1;351;2;349;162;157;5;1;0;10;0;0;1;1;0;143;;0;;31;0
BIZKAIA;94;IGORRE;1;3;U;766;495;1;494;5;489;271;245;9;0;0;28;4;0;10;0;0;159;;2;;32;0
BIZKAIA;95;ZALDIBAR;1;1;A;654;423;1;422;2;420;231;142;24;0;0;43;0;0;3;0;0;158;;2;;47;1
BIZKAIA;95;ZALDIBAR;1;1;B;499;327;2;325;1;324;172;99;15;0;1;44;2;2;2;1;0;110;;4;;42;2
BIZKAIA;95;ZALDIBAR;1;2;U;522;297;1;296;3;293;225;110;30;0;0;27;2;2;5;0;0;67;;0;;49;1
BIZKAIA;95;ZALDIBAR;1;3;U;666;419;2;417;2;415;247;112;41;0;0;89;1;1;9;1;1;98;;3;;59;0
BIZKAIA;96;ZALLA;1;1;A;631;482;4;478;2;476;149;251;32;0;0;29;3;0;8;1;0;76;;4;;72;0
BIZKAIA;96;ZALLA;1;1;B;837;617;5;612;9;603;220;320;23;0;0;41;4;1;7;0;0;107;;7;;90;3
BIZKAIA;96;ZALLA;1;2;U;703;503;4;499;0;499;200;260;23;0;0;34;1;0;7;0;0;84;;1;;88;1
BIZKAIA;96;ZALLA;1;3;A;777;550;7;543;3;540;227;297;8;0;0;58;3;0;10;0;0;75;;2;;84;3
BIZKAIA;96;ZALLA;1;3;B;906;630;9;621;5;616;276;335;11;0;0;59;4;2;7;1;0;88;;1;;107;1
BIZKAIA;96;ZALLA;1;4;A;534;391;4;387;2;385;143;214;13;1;1;32;2;1;2;1;1;54;;3;;59;1
BIZKAIA;96;ZALLA;1;4;B;654;470;4;466;7;459;184;274;23;0;0;25;3;1;5;0;0;65;;3;;59;1
BIZKAIA;96;ZALLA;2;1;A;773;495;5;490;1;489;278;240;26;0;0;50;2;2;4;1;0;69;;4;;91;0
BIZKAIA;96;ZALLA;2;1;B;751;489;7;482;4;478;262;239;19;0;0;48;4;5;5;1;0;77;;2;;73;5
BIZKAIA;97;ZARATAMO;1;1;U;569;399;3;396;0;396;170;169;15;0;0;9;1;0;2;0;0;152;;2;;46;0
BIZKAIA;97;ZARATAMO;1;2;U;729;416;2;414;2;412;313;187;20;0;1;52;6;0;8;0;1;53;;4;;80;0
BIZKAIA;901;DERIO;1;1;A;509;329;1;328;2;326;180;145;22;0;1;48;1;0;6;0;0;57;;1;;44;1
BIZKAIA;901;DERIO;1;1;B;558;352;1;351;3;348;206;133;42;0;2;55;2;1;3;0;1;50;;1;;57;1
BIZKAIA;901;DERIO;1;2;A;870;596;2;594;9;585;274;306;12;0;0;62;8;3;11;1;0;93;;5;;84;0
BIZKAIA;901;DERIO;1;2;B;854;616;4;612;6;606;238;286;24;0;0;65;11;1;13;1;0;102;;4;;98;1
BIZKAIA;901;DERIO;1;3;A;479;298;4;294;1;293;181;117;21;0;0;62;1;0;3;0;0;43;;2;;44;0
BIZKAIA;901;DERIO;1;3;B;546;345;3;342;0;342;201;132;24;0;0;79;3;1;7;0;1;44;;1;;50;0
BIZKAIA;901;DERIO;1;4;A;524;354;1;353;1;352;170;165;14;0;0;36;5;3;7;1;0;59;;1;;60;1
BIZKAIA;901;DERIO;1;4;B;538;370;5;365;3;362;168;164;19;0;0;33;3;1;7;0;0;55;;6;;73;1
BIZKAIA;902;ERANDIO;1;1;A;576;336;2;334;2;332;240;121;19;0;0;49;6;0;6;0;0;72;;3;;56;0
BIZKAIA;902;ERANDIO;1;1;B;585;334;5;329;2;327;251;121;18;0;1;35;0;0;8;1;0;63;;4;;74;2
BIZKAIA;902;ERANDIO;1;2;U;585;345;0;345;2;343;240;160;10;0;0;48;5;0;2;0;0;87;;2;;29;0
BIZKAIA;902;ERANDIO;1;3;A;561;347;1;346;2;344;214;149;14;0;0;42;3;0;5;0;0;61;;1;;69;0
BIZKAIA;902;ERANDIO;1;3;B;567;305;3;302;2;300;262;118;17;0;0;38;3;0;4;0;0;53;;8;;58;1
BIZKAIA;902;ERANDIO;1;4;U;857;532;9;523;2;521;325;227;32;1;0;73;5;1;6;2;0;82;;4;;87;1
BIZKAIA;902;ERANDIO;1;5;U;690;407;3;404;3;401;283;178;21;1;0;40;2;1;8;1;0;72;;7;;69;1
BIZKAIA;902;ERANDIO;1;6;U;725;435;0;435;4;431;290;184;24;0;0;57;0;0;6;2;1;61;;9;;85;2
BIZKAIA;902;ERANDIO;1;7;A;535;320;1;319;1;318;215;135;23;0;0;48;8;0;3;1;0;43;;1;;55;1
BIZKAIA;902;ERANDIO;1;7;B;528;307;1;306;2;304;221;120;10;1;0;46;6;0;6;1;0;45;;5;;62;2
BIZKAIA;902;ERANDIO;1;8;A;533;321;2;319;0;319;212;149;15;0;1;51;1;0;0;2;1;46;;3;;49;1
BIZKAIA;902;ERANDIO;1;8;B;566;358;3;355;4;351;208;149;21;0;0;56;2;0;5;0;0;50;;2;;66;0
BIZKAIA;902;ERANDIO;1;9;U;643;407;3;404;3;401;236;188;23;0;2;64;2;0;2;3;0;57;;1;;59;0
BIZKAIA;902;ERANDIO;2;1;A;621;362;2;360;5;355;259;142;16;0;0;67;3;0;11;0;0;35;;2;;78;1
BIZKAIA;902;ERANDIO;2;1;B;601;348;1;347;2;345;253;145;18;0;0;43;4;0;8;0;0;39;;5;;83;0
BIZKAIA;902;ERANDIO;2;2;A;589;340;1;339;2;337;249;139;28;0;0;65;5;0;5;2;0;24;;2;;65;2
BIZKAIA;902;ERANDIO;2;2;B;668;375;2;373;2;371;293;125;42;0;0;62;1;1;7;0;0;32;;6;;92;3
BIZKAIA;902;ERANDIO;2;3;A;711;437;5;432;4;428;274;155;36;0;0;78;5;1;8;0;0;43;;6;;94;2
BIZKAIA;902;ERANDIO;2;3;B;660;386;0;386;2;384;274;142;19;0;1;79;4;0;6;1;0;41;;5;;85;1
BIZKAIA;902;ERANDIO;2;4;A;468;256;1;255;5;250;212;95;21;0;0;43;2;1;4;1;1;37;;0;;45;0
BIZKAIA;902;ERANDIO;2;4;B;483;266;2;264;2;262;217;106;22;0;0;45;3;2;4;0;0;29;;4;;47;0
BIZKAIA;902;ERANDIO;2;5;U;672;430;1;429;1;428;242;168;50;0;0;59;1;0;8;1;1;46;;7;;87;0
BIZKAIA;902;ERANDIO;2;6;U;651;395;0;395;3;392;256;160;40;0;0;55;5;0;5;2;0;49;;10;;1;65
BIZKAIA;902;ERANDIO;2;7;U;520;316;5;311;1;310;204;88;23;0;1;99;2;1;10;0;1;24;;3;;57;1
BIZKAIA;902;ERANDIO;2;8;A;749;443;2;441;1;440;306;157;25;0;0;84;5;0;9;0;0;63;;4;;90;3
BIZKAIA;902;ERANDIO;2;8;B;724;428;3;425;3;422;296;142;23;0;1;77;7;1;13;0;1;49;;3;;101;4
BIZKAIA;902;ERANDIO;3;1;A;575;297;2;295;3;292;278;115;12;0;0;32;2;0;8;1;0;61;;0;;61;0
BIZKAIA;902;ERANDIO;3;1;B;358;207;3;204;0;204;151;102;6;1;0;16;4;1;0;0;1;39;;0;;34;0
BIZKAIA;902;ERANDIO;3;2;A;679;462;6;456;3;453;217;250;14;0;0;23;3;2;4;0;0;101;;1;;55;0
BIZKAIA;902;ERANDIO;3;2;B;613;419;3;416;2;414;194;235;26;0;0;22;2;0;7;0;0;76;;2;;43;1
BIZKAIA;902;ERANDIO;3;3;U;646;426;4;422;1;421;220;285;16;0;0;8;4;0;1;1;0;92;;0;;14;0
BIZKAIA;903;LOIU;1;1;A;528;387;3;384;3;381;141;241;44;0;0;19;2;0;8;1;0;41;;0;;25;0
BIZKAIA;903;LOIU;1;1;B;512;351;2;349;0;349;161;220;42;0;0;11;5;0;9;0;0;35;;1;;26;0
BIZKAIA;903;LOIU;1;1;C;400;276;1;275;3;272;124;131;21;1;0;16;6;0;2;1;0;46;;1;;47;0
BIZKAIA;903;LOIU;1;1;D;377;295;0;295;1;294;82;211;20;0;0;5;1;0;2;0;0;40;;0;;15;0
BIZKAIA;904;SONDIKA;1;1;A;734;504;3;501;4;497;230;276;30;0;0;35;4;1;6;1;0;95;;1;;47;1
BIZKAIA;904;SONDIKA;1;1;B;608;381;4;377;4;373;227;181;29;0;0;34;4;0;5;0;0;63;;0;;57;0
BIZKAIA;904;SONDIKA;1;2;A;769;560;0;560;2;558;209;293;39;0;1;30;4;0;7;1;1;104;;0;;78;0
BIZKAIA;904;SONDIKA;1;2;B;702;493;5;488;1;487;209;265;23;0;0;35;3;0;16;0;0;85;;3;;57;0
BIZKAIA;904;SONDIKA;1;3;U;680;492;2;490;4;486;188;271;55;0;0;27;7;2;5;1;0;66;;2;;48;2
BIZKAIA;905;ZAMUDIO;1;1;A;898;612;11;601;5;596;286;297;22;0;0;35;2;1;7;2;0;159;;2;;68;1
BIZKAIA;905;ZAMUDIO;1;1;B;839;555;0;555;3;552;284;231;17;0;1;46;3;2;10;0;0;154;;2;;85;1
BIZKAIA;905;ZAMUDIO;1;2;U;808;566;1;565;2;563;242;334;8;0;0;15;5;0;3;0;0;162;;1;;35;0
BIZKAIA;906;FORUA;1;1;U;767;557;2;555;2;553;210;285;11;0;0;14;0;2;1;0;0;207;;0;;33;0
BIZKAIA;907;KORTEZUBI;1;1;U;346;283;0;283;0;283;63;164;2;0;0;3;0;0;1;0;0;98;;0;;15;0
BIZKAIA;908;MURUETA;1;1;U;249;203;1;202;4;198;46;102;4;0;0;3;0;0;1;0;0;74;;0;;14;0
BIZKAIA;909;NABARNIZ;1;1;U;209;177;1;176;1;175;32;61;0;0;0;0;0;0;0;0;0;102;;0;;12;0
BIZKAIA;910;IURRETA;1;1;U;784;548;0;548;2;546;236;263;5;0;1;16;1;0;4;0;0;228;;0;;28;0
BIZKAIA;910;IURRETA;1;2;U;590;340;0;340;0;340;250;106;45;1;0;63;5;0;4;0;0;72;;4;;40;0
BIZKAIA;910;IURRETA;1;3;A;781;497;0;497;0;497;284;195;41;1;0;75;1;3;5;0;1;108;;2;;65;0
BIZKAIA;910;IURRETA;1;3;B;737;450;0;450;1;449;287;166;49;0;0;73;2;0;14;2;0;79;;1;;61;2
BIZKAIA;911;AJANGIZ;1;1;U;382;291;0;291;2;289;91;94;1;0;0;0;1;0;0;0;0;175;;0;;18;0
BIZKAIA;912;ALONSOTEGI;1;1;U;724;503;5;498;4;494;221;240;15;0;1;55;2;0;4;1;1;99;;0;;76;0
BIZKAIA;912;ALONSOTEGI;1;2;U;759;560;2;558;10;548;199;233;22;0;1;30;7;0;9;0;0;146;;3;;97;0
BIZKAIA;912;ALONSOTEGI;1;3;A;625;453;8;445;5;440;172;203;24;0;0;42;3;0;6;0;0;90;;3;;69;0
BIZKAIA;912;ALONSOTEGI;1;3;B;208;133;0;133;2;131;75;56;2;0;0;5;1;0;0;0;0;48;;0;;19;0
BIZKAIA;913;ZIERBENA;1;1;A;604;416;9;407;2;405;188;210;8;0;0;18;2;0;3;0;0;90;;2;;71;1
BIZKAIA;913;ZIERBENA;1;1;B;642;441;8;433;11;422;201;227;21;0;0;16;3;0;4;0;0;83;;0;;68;0
BIZKAIA;914;ARRATZU;1;1;U;328;279;1;278;1;277;49;155;0;0;0;1;0;0;0;0;0;107;;0;;14;0
BIZKAIA;915;ZIORTZA - BOLIBAR;1;1;U;363;256;0;256;1;255;107;110;3;0;0;1;0;0;0;0;0;137;;0;;3;1
BIZKAIA;999;MUNICIPIO CERA BIZKAIA;1;1;U;37033;1458;4;1454;12;1442;35575;494;210;1;5;163;20;11;49;4;2;220;;3;;256;4
GIPUZKOA;1;ABALTZISKETA;1;1;U;252;163;0;163;3;160;89;73;0;;;0;1;0;0;;;79;;0;0;7;0
GIPUZKOA;2;ADUNA;1;1;U;343;231;0;231;4;227;112;68;2;;;0;0;0;0;;;139;;2;0;16;0
GIPUZKOA;3;AIZARNAZABAL;1;1;U;542;354;1;353;2;351;188;103;1;;;5;1;1;4;;;203;;1;0;32;0
GIPUZKOA;4;ALBIZTUR;1;1;U;248;146;0;146;0;146;102;79;0;;;8;1;0;0;;;45;;0;0;13;0
GIPUZKOA;5;ALEGIA;1;1;A;598;385;1;384;1;383;213;132;5;;;9;2;1;1;;;208;;3;1;21;0
GIPUZKOA;5;ALEGIA;1;1;B;660;411;1;410;2;408;249;154;5;;;16;3;0;1;;;183;;1;0;45;0
GIPUZKOA;6;ALKIZA;1;1;U;259;154;0;154;0;154;105;57;2;;;2;2;0;0;;;76;;2;0;13;0
GIPUZKOA;7;ALTZO;1;1;U;309;222;0;222;1;221;87;59;1;;;0;3;0;0;;;139;;0;1;17;1
GIPUZKOA;8;AMEZKETA;1;1;U;720;410;0;410;6;404;310;132;7;;;7;0;1;0;;;224;;0;0;32;1
GIPUZKOA;9;ANDOAIN;1;1;A;524;338;0;338;1;337;186;126;12;;;31;1;0;6;;;100;;1;0;60;0
GIPUZKOA;9;ANDOAIN;1;1;B;505;314;0;314;1;313;191;101;18;;;44;1;0;0;;;97;;0;0;48;4
GIPUZKOA;9;ANDOAIN;1;2;A;688;436;0;436;3;433;252;130;26;;;22;1;0;3;;;176;;3;0;72;0
GIPUZKOA;9;ANDOAIN;1;2;B;647;416;1;415;6;409;231;105;15;;;38;3;0;2;;;168;;0;1;76;1
GIPUZKOA;9;ANDOAIN;1;3;A;724;400;1;399;3;396;324;94;15;;;47;3;0;7;;;122;;1;1;105;1
GIPUZKOA;9;ANDOAIN;1;3;B;720;405;0;405;3;402;315;83;15;;;45;8;0;12;;;124;;5;0;110;0
GIPUZKOA;9;ANDOAIN;1;4;U;789;444;0;444;1;443;345;114;28;;;65;3;2;12;;;142;;4;1;70;2
GIPUZKOA;9;ANDOAIN;1;5;A;467;297;5;292;3;289;170;69;10;;;94;1;2;8;;;52;;1;0;52;0
GIPUZKOA;9;ANDOAIN;1;5;B;468;275;3;272;4;268;193;59;28;;;75;4;0;10;;;31;;2;0;58;1
GIPUZKOA;9;ANDOAIN;1;6;A;431;237;0;237;2;235;194;66;25;;;55;3;1;5;;;46;;4;0;30;0
GIPUZKOA;9;ANDOAIN;1;6;B;484;277;0;277;1;276;207;80;15;;;69;5;1;4;;;59;;0;0;42;1
GIPUZKOA;9;ANDOAIN;1;7;A;507;322;3;319;0;319;185;103;24;;;61;1;1;4;;;74;;3;0;48;0
GIPUZKOA;9;ANDOAIN;1;7;B;476;278;3;275;2;273;198;73;22;;;66;1;1;9;;;53;;1;0;47;0
GIPUZKOA;9;ANDOAIN;1;8;A;454;263;0;263;3;260;191;75;12;;;30;5;1;6;;;75;;2;0;50;4
GIPUZKOA;9;ANDOAIN;1;8;B;473;271;1;270;0;270;202;81;8;;;21;2;0;8;;;86;;1;0;62;1
GIPUZKOA;9;ANDOAIN;1;9;A;465;263;1;262;2;260;202;86;10;;;30;0;0;3;;;87;;4;0;40;0
GIPUZKOA;9;ANDOAIN;1;9;B;442;225;1;224;1;223;217;51;22;;;33;0;2;7;;;74;;0;0;34;0
GIPUZKOA;9;ANDOAIN;1;10;A;493;287;1;286;1;285;206;86;22;;;53;2;4;5;;;65;;1;0;45;2
GIPUZKOA;9;ANDOAIN;1;10;B;505;309;0;309;2;307;196;85;21;;;59;1;1;5;;;87;;2;0;43;3
GIPUZKOA;9;ANDOAIN;1;11;A;605;358;1;357;0;357;247;99;27;;;63;3;0;8;;;91;;5;0;61;0
GIPUZKOA;9;ANDOAIN;1;11;B;575;347;2;345;4;341;228;92;31;;;76;4;0;12;;;71;;4;0;50;1
GIPUZKOA;10;ANOETA;1;1;A;703;448;0;448;2;446;255;139;19;;;22;3;0;1;;;199;;3;0;59;1
GIPUZKOA;10;ANOETA;1;1;B;814;556;2;554;4;550;258;172;16;;;26;4;1;2;;;260;;1;2;65;1
GIPUZKOA;11;ANTZUOLA;1;1;A;835;624;3;621;4;617;211;188;11;;;25;3;0;5;;;325;;2;1;57;0
GIPUZKOA;11;ANTZUOLA;1;1;B;818;596;3;593;4;589;222;181;20;;;50;4;0;1;;;267;;3;0;61;2
GIPUZKOA;12;ARAMA;1;1;U;147;107;0;107;4;103;40;39;0;;;1;0;0;1;;;56;;1;0;5;0
GIPUZKOA;13;ARETXABALETA;1;1;A;591;386;5;381;2;379;205;154;16;;;40;4;0;1;;;115;;0;0;48;1
GIPUZKOA;13;ARETXABALETA;1;1;B;581;382;2;380;2;378;199;154;12;;;40;4;1;6;;;119;;0;0;41;1
GIPUZKOA;13;ARETXABALETA;1;2;A;722;489;1;488;1;487;233;206;13;;;29;0;0;4;;;177;;4;0;54;0
GIPUZKOA;13;ARETXABALETA;1;2;B;812;538;1;537;3;534;274;225;17;;;33;1;2;0;;;181;;4;0;70;1
GIPUZKOA;13;ARETXABALETA;1;3;A;763;489;1;488;3;485;274;191;18;;;42;1;2;6;;;167;;1;0;56;1
GIPUZKOA;13;ARETXABALETA;1;3;B;760;482;0;482;1;481;278;186;18;;;42;3;0;5;;;166;;1;0;59;1
GIPUZKOA;13;ARETXABALETA;1;4;A;605;391;1;390;1;389;214;140;4;;;14;0;1;1;;;184;;1;0;43;1
GIPUZKOA;13;ARETXABALETA;1;4;B;570;375;2;373;1;372;195;116;7;;;22;5;0;3;;;169;;2;0;48;0
GIPUZKOA;14;ASTEASU;1;1;A;551;302;2;300;0;300;249;103;4;;;11;2;0;2;;;140;;1;0;36;1
GIPUZKOA;14;ASTEASU;1;1;B;558;299;4;295;0;295;259;86;5;;;6;1;0;0;;;166;;0;0;31;0
GIPUZKOA;15;ATAUN;1;1;A;866;646;2;644;5;639;220;221;2;;;1;2;0;0;;;366;;2;1;44;0
GIPUZKOA;15;ATAUN;1;1;B;400;287;3;284;2;282;113;83;1;;;1;0;0;0;;;191;;0;0;6;0
GIPUZKOA;16;AIA;1;1;U;871;506;1;505;1;504;365;249;3;;;10;6;0;0;;;191;;0;0;43;2
GIPUZKOA;16;AIA;1;2;U;669;448;0;448;0;448;221;230;4;;;6;1;0;0;;;171;;0;1;35;0
GIPUZKOA;17;AZKOITIA;1;1;A;579;331;0;331;2;329;248;142;9;;;24;1;2;2;;;111;;1;1;35;1
GIPUZKOA;17;AZKOITIA;1;1;B;603;354;2;352;0;352;249;133;13;;;44;1;0;6;;;116;;1;0;37;1
GIPUZKOA;17;AZKOITIA;1;2;U;749;479;0;479;1;478;270;201;21;;;29;8;2;2;;;173;;3;0;39;0
GIPUZKOA;17;AZKOITIA;2;1;U;757;477;2;475;3;472;280;203;17;;;21;3;1;5;;;183;;0;3;32;4
GIPUZKOA;17;AZKOITIA;2;2;A;862;531;1;530;2;528;331;207;10;;;44;1;2;6;;;206;;4;1;46;1
GIPUZKOA;17;AZKOITIA;2;2;B;866;507;5;502;6;496;359;203;19;;;46;4;0;4;;;162;;3;0;54;1
GIPUZKOA;17;AZKOITIA;3;1;A;482;292;1;291;3;288;190;121;8;;;17;0;1;2;;;99;;3;0;35;2
GIPUZKOA;17;AZKOITIA;3;1;B;498;308;0;308;0;308;190;132;13;;;15;1;0;4;;;104;;0;1;37;1
GIPUZKOA;17;AZKOITIA;3;2;A;524;365;2;363;3;360;159;195;14;;;19;1;0;0;;;105;;0;2;24;0
GIPUZKOA;17;AZKOITIA;3;2;B;554;379;3;376;3;373;175;181;16;;;30;0;0;2;;;116;;0;0;27;1
GIPUZKOA;17;AZKOITIA;3;3;U;674;449;2;447;1;446;225;199;10;;;22;3;0;0;;;170;;1;1;39;1
GIPUZKOA;17;AZKOITIA;3;4;A;704;495;0;495;3;492;209;257;21;;;20;4;1;3;;;148;;1;4;32;1
GIPUZKOA;17;AZKOITIA;3;4;B;682;495;1;494;2;492;187;250;14;;;19;3;0;6;;;156;;0;3;41;0
GIPUZKOA;18;AZPEITIA;1;1;A;522;360;2;358;2;356;162;135;8;;;4;0;0;0;;;189;;1;0;18;1
GIPUZKOA;18;AZPEITIA;1;1;B;457;290;0;290;0;290;167;103;6;;;7;0;0;1;;;157;;0;0;16;0
GIPUZKOA;18;AZPEITIA;1;2;A;511;346;3;343;1;342;165;118;11;;;10;0;0;0;;;173;;0;0;30;0
GIPUZKOA;18;AZPEITIA;1;2;B;619;389;3;386;6;380;230;135;7;;;2;0;0;4;;;202;;0;0;30;0
GIPUZKOA;18;AZPEITIA;1;3;A;660;447;2;445;5;440;213;194;5;;;14;2;0;2;;;194;;1;0;28;0
GIPUZKOA;18;AZPEITIA;1;3;B;594;374;0;374;3;371;220;159;14;;;5;2;0;5;;;165;;0;0;20;1
GIPUZKOA;18;AZPEITIA;1;4;A;799;518;1;517;4;513;281;232;11;;;8;1;0;3;;;226;;0;1;31;0
GIPUZKOA;18;AZPEITIA;1;4;B;814;517;2;515;5;510;297;240;12;;;14;0;1;5;;;211;;0;0;26;1
GIPUZKOA;18;AZPEITIA;1;5;A;907;594;1;593;4;589;313;279;19;;;15;1;1;4;;;246;;0;0;24;0
GIPUZKOA;18;AZPEITIA;1;5;B;894;587;3;584;4;580;307;282;15;;;19;1;1;1;;;230;;1;2;27;1
GIPUZKOA;18;AZPEITIA;1;6;A;713;440;1;439;5;434;273;157;13;;;22;1;2;2;;;216;;0;0;20;1
GIPUZKOA;18;AZPEITIA;1;6;B;731;429;1;428;0;428;302;171;16;;;32;3;1;6;;;164;;0;0;35;0
GIPUZKOA;18;AZPEITIA;1;7;A;542;337;1;336;2;334;205;163;4;;;3;0;2;0;;;144;;1;0;17;0
GIPUZKOA;18;AZPEITIA;1;7;B;457;283;1;282;1;281;174;155;4;;;3;0;1;1;;;107;;0;0;10;0
GIPUZKOA;18;AZPEITIA;1;8;U;565;376;0;376;3;373;189;200;1;;;5;1;0;0;;;152;;0;0;14;0
GIPUZKOA;18;AZPEITIA;1;9;A;660;474;0;474;0;474;186;192;11;;;17;0;2;1;;;219;;0;0;32;0
GIPUZKOA;18;AZPEITIA;1;9;B;617;422;1;421;2;419;195;160;12;;;18;0;0;2;;;197;;1;0;29;0
GIPUZKOA;19;BEASAIN;1;1;U;785;401;0;401;1;400;384;118;25;;;57;5;0;7;;;99;;3;0;83;3
GIPUZKOA;19;BEASAIN;1;2;A;818;522;0;522;6;516;296;225;24;;;39;3;3;1;;;164;;2;0;54;1
GIPUZKOA;19;BEASAIN;1;2;B;777;487;3;484;2;482;290;190;23;;;53;3;1;2;;;125;;2;0;82;1
GIPUZKOA;19;BEASAIN;1;3;A;691;440;0;440;3;437;251;229;15;;;37;7;0;2;;;92;;1;1;52;1
GIPUZKOA;19;BEASAIN;1;3;B;792;498;0;498;5;493;294;233;21;;;37;6;0;5;;;139;;1;0;51;0
GIPUZKOA;19;BEASAIN;1;4;A;588;345;1;344;6;338;243;134;20;;;38;1;0;5;;;91;;0;1;48;0
GIPUZKOA;19;BEASAIN;1;4;B;657;381;3;378;3;375;276;166;22;;;39;1;1;1;;;94;;2;0;49;0
GIPUZKOA;19;BEASAIN;1;5;A;756;471;0;471;4;467;285;209;24;;;37;1;0;2;;;139;;1;0;54;0
GIPUZKOA;19;BEASAIN;1;5;B;813;540;4;536;5;531;273;238;21;;;37;1;2;2;;;157;;1;0;70;2
GIPUZKOA;19;BEASAIN;1;7;A;856;562;1;561;1;560;294;231;24;;;42;4;1;9;;;169;;0;1;78;1
GIPUZKOA;19;BEASAIN;1;7;B;927;611;3;608;4;604;316;263;25;;;48;3;1;13;;;172;;1;0;76;2
GIPUZKOA;19;BEASAIN;1;8;U;516;353;2;351;4;347;163;131;21;;;53;1;0;4;;;88;;4;0;44;1
GIPUZKOA;19;BEASAIN;1;9;A;492;253;1;252;0;252;239;62;11;;;47;4;0;3;;;57;;4;0;64;0
GIPUZKOA;19;BEASAIN;1;9;B;496;283;0;283;0;283;213;103;10;;;50;5;0;8;;;57;;3;0;46;1
GIPUZKOA;20;BEIZAMA;1;1;U;125;82;0;82;1;81;43;29;1;;;0;1;0;1;;;43;;0;1;4;1
GIPUZKOA;21;BELAUNTZA;1;1;U;198;109;0;109;1;108;89;43;1;;;2;0;0;0;;;48;;1;0;13;0
GIPUZKOA;22;BERASTEGI;1;1;U;844;551;2;549;8;541;293;224;10;;;8;4;0;0;;;253;;1;0;41;0
GIPUZKOA;23;BERROBI;1;1;U;443;247;0;247;1;246;196;71;9;;;13;0;0;3;;;128;;0;1;21;0
GIPUZKOA;24;BIDANIA-GOIATZ;1;1;U;384;238;0;238;1;237;146;68;5;;;1;0;1;0;;;143;;1;0;18;0
GIPUZKOA;25;ZEGAMA;1;1;A;593;439;1;438;2;436;154;170;3;;;10;3;0;1;;;217;;1;0;31;0
GIPUZKOA;25;ZEGAMA;1;1;B;560;363;0;363;3;360;197;152;0;;;6;1;1;0;;;167;;1;0;31;1
GIPUZKOA;26;ZERAIN;1;1;U;197;162;12;150;2;148;35;71;0;;;0;0;0;0;;;72;;0;0;5;0
GIPUZKOA;27;ZESTOA;1;1;A;835;554;0;554;0;554;281;233;8;;;10;2;0;0;;;247;;0;0;53;1
GIPUZKOA;27;ZESTOA;1;1;B;947;598;0;598;3;595;349;223;4;;;13;2;0;3;;;292;;3;0;55;0
GIPUZKOA;27;ZESTOA;1;2;A;415;252;0;252;2;250;163;109;1;;;11;1;0;0;;;92;;0;0;36;0
GIPUZKOA;27;ZESTOA;1;2;B;238;163;0;163;0;163;75;72;2;;;0;0;0;0;;;82;;0;0;7;0
GIPUZKOA;27;ZESTOA;1;2;C;380;218;1;217;1;216;162;65;0;;;7;0;0;0;;;117;;0;1;25;1
GIPUZKOA;28;ZIZURKIL;1;1;A;755;519;1;518;3;515;236;168;14;;;22;3;0;4;;;254;;5;0;45;0
GIPUZKOA;28;ZIZURKIL;1;1;B;666;442;0;442;3;439;224;148;13;;;25;1;0;3;;;204;;4;0;40;1
GIPUZKOA;28;ZIZURKIL;1;2;U;805;446;7;439;5;434;359;145;20;;;55;4;1;8;;;121;;7;0;72;1
GIPUZKOA;29;DEBA;1;1;A;667;466;2;464;2;462;201;254;16;;;18;1;0;1;;;118;;1;1;51;1
GIPUZKOA;29;DEBA;1;1;B;678;472;1;471;0;471;206;219;22;;;24;1;1;8;;;151;;2;1;40;2
GIPUZKOA;29;DEBA;1;2;A;693;462;1;461;4;457;231;202;16;;;28;2;2;4;;;138;;2;2;61;0
GIPUZKOA;29;DEBA;1;2;B;690;481;0;481;5;476;209;205;19;;;26;1;3;1;;;154;;3;0;64;0
GIPUZKOA;29;DEBA;1;3;U;776;495;0;495;2;493;281;195;12;;;42;1;0;9;;;153;;1;2;78;0
GIPUZKOA;29;DEBA;2;1;U;791;503;1;502;3;499;288;179;3;;;3;1;0;1;;;283;;1;0;28;0
GIPUZKOA;30;EIBAR;1;1;A;627;429;1;428;2;426;198;176;27;;;86;3;0;2;;;87;;1;0;44;0
GIPUZKOA;30;EIBAR;1;1;B;649;424;2;422;4;418;225;184;29;;;70;2;0;10;;;82;;3;0;36;2
GIPUZKOA;30;EIBAR;1;2;A;553;339;0;339;1;338;214;112;26;;;59;5;0;0;;;89;;0;0;46;1
GIPUZKOA;30;EIBAR;1;2;B;563;368;2;366;3;363;195;127;32;;;67;2;2;4;;;82;;3;0;44;0
GIPUZKOA;30;EIBAR;1;3;U;856;593;1;592;1;591;263;232;48;;;102;10;1;6;;;126;;1;1;62;2
GIPUZKOA;30;EIBAR;1;4;A;643;381;1;380;2;378;262;114;20;;;93;3;0;4;;;81;;3;0;60;0
GIPUZKOA;30;EIBAR;1;4;B;610;333;1;332;2;330;277;83;31;;;93;4;0;7;;;59;;3;0;50;0
GIPUZKOA;30;EIBAR;1;5;A;532;308;3;305;0;305;224;61;23;;;109;1;0;0;;;57;;1;0;53;0
GIPUZKOA;30;EIBAR;1;5;B;521;325;2;323;2;321;196;57;23;;;102;4;1;3;;;60;;3;0;68;0
GIPUZKOA;30;EIBAR;2;1;U;857;503;1;502;2;500;354;129;14;;;74;4;1;3;;;186;;9;0;80;0
GIPUZKOA;30;EIBAR;2;2;A;452;244;1;243;2;241;208;53;19;;;55;4;2;1;;;69;;1;0;34;3
GIPUZKOA;30;EIBAR;2;2;B;470;234;1;233;0;233;236;60;29;;;53;2;1;3;;;50;;1;0;31;3
GIPUZKOA;30;EIBAR;2;3;A;491;309;2;307;0;307;182;64;28;;;134;5;1;5;;;35;;0;0;34;1
GIPUZKOA;30;EIBAR;2;3;B;490;305;0;305;3;302;185;52;31;;;160;3;0;5;;;26;;0;0;25;0
GIPUZKOA;30;EIBAR;2;4;A;500;248;0;248;2;246;252;49;22;;;66;1;0;3;;;55;;1;0;49;0
GIPUZKOA;30;EIBAR;2;4;B;487;281;1;280;2;278;206;77;24;;;80;2;0;2;;;36;;1;2;53;1
GIPUZKOA;30;EIBAR;2;5;A;489;296;0;296;3;293;193;106;20;;;47;7;1;1;;;72;;1;0;38;0
GIPUZKOA;30;EIBAR;2;5;B;430;292;1;291;0;291;138;85;17;;;57;5;0;8;;;72;;2;0;45;0
GIPUZKOA;30;EIBAR;3;1;A;675;385;2;383;2;381;290;92;20;;;92;4;1;7;;;88;;0;1;74;2
GIPUZKOA;30;EIBAR;3;1;B;552;277;1;276;5;271;275;68;16;;;72;1;1;2;;;63;;3;0;45;0
GIPUZKOA;30;EIBAR;3;3;U;789;442;2;440;1;439;347;166;27;;;103;0;0;2;;;137;;3;1;0;0
GIPUZKOA;30;EIBAR;3;4;U;652;420;1;419;1;418;232;126;36;;;90;1;3;3;;;106;;0;0;53;0
GIPUZKOA;30;EIBAR;4;1;A;455;282;1;281;3;278;173;74;10;;;54;1;2;6;;;84;;1;0;46;0
GIPUZKOA;30;EIBAR;4;1;B;453;260;0;260;0;260;193;69;20;;;52;3;1;2;;;65;;2;0;45;1
GIPUZKOA;30;EIBAR;4;2;U;745;484;0;484;1;483;261;182;35;;;66;0;0;10;;;113;;3;0;71;3
GIPUZKOA;30;EIBAR;4;3;A;522;368;0;368;0;368;154;170;23;;;44;1;1;7;;;89;;3;0;30;0
GIPUZKOA;30;EIBAR;4;3;B;488;321;1;320;4;316;167;150;29;;;36;2;1;6;;;59;;4;0;28;1
GIPUZKOA;30;EIBAR;4;4;U;537;387;1;386;1;385;150;175;30;;;63;2;1;1;;;64;;0;0;48;1
GIPUZKOA;30;EIBAR;4;5;U;769;445;3;442;0;442;324;141;23;;;78;2;1;8;;;117;;4;0;67;1
GIPUZKOA;30;EIBAR;4;6;U;780;492;1;491;1;490;288;178;24;;;88;7;2;5;;;120;;4;0;61;1
GIPUZKOA;30;EIBAR;5;1;A;488;283;1;282;2;280;205;96;17;;;61;4;2;2;;;68;;0;0;30;0
GIPUZKOA;30;EIBAR;5;1;B;507;287;0;287;2;285;220;85;29;;;65;1;0;5;;;57;;2;0;40;1
GIPUZKOA;30;EIBAR;5;2;U;689;462;1;461;2;459;227;234;32;;;53;0;2;8;;;93;;2;0;35;0
GIPUZKOA;30;EIBAR;5;3;A;549;324;0;324;2;322;225;114;19;;;79;0;0;4;;;60;;3;0;41;2
GIPUZKOA;30;EIBAR;5;3;B;610;351;1;350;0;350;259;95;38;;;89;3;0;5;;;59;;7;1;52;1
GIPUZKOA;30;EIBAR;5;4;A;466;287;1;286;3;283;179;98;27;;;46;1;1;1;;;73;;1;0;35;0
GIPUZKOA;30;EIBAR;5;4;B;454;261;1;260;1;259;193;89;22;;;46;1;1;6;;;59;;1;0;33;1
GIPUZKOA;31;ELDUAIN;1;1;U;174;112;0;112;1;111;62;41;2;;;0;0;0;0;;;60;;0;1;7;0
GIPUZKOA;32;ELGOIBAR;1;1;A;553;352;7;345;1;344;201;128;14;;;29;3;1;2;;;123;;1;0;43;0
GIPUZKOA;32;ELGOIBAR;1;1;B;602;374;4;370;1;369;228;155;14;;;41;5;0;4;;;92;;0;1;57;0
GIPUZKOA;32;ELGOIBAR;1;2;A;454;280;0;280;3;277;174;109;14;;;16;0;1;6;;;102;;1;0;28;0
GIPUZKOA;32;ELGOIBAR;1;2;B;446;275;0;275;1;274;171;112;15;;;22;2;1;5;;;91;;2;0;24;0
GIPUZKOA;32;ELGOIBAR;1;3;A;201;131;0;131;1;130;70;39;8;;;2;0;0;6;;;52;;1;0;22;0
GIPUZKOA;32;ELGOIBAR;1;3;B;672;439;4;435;3;432;233;235;21;;;24;1;1;4;;;123;;1;0;22;0
GIPUZKOA;32;ELGOIBAR;1;3;C;619;409;0;409;2;407;210;198;20;;;26;0;0;5;;;129;;3;0;25;1
GIPUZKOA;32;ELGOIBAR;1;4;U;630;384;2;382;0;382;246;209;25;;;24;0;1;4;;;93;;0;0;26;0
GIPUZKOA;32;ELGOIBAR;1;5;A;475;299;0;299;0;299;176;130;15;;;19;3;0;5;;;97;;2;0;27;1
GIPUZKOA;32;ELGOIBAR;1;5;B;471;295;0;295;1;294;176;146;21;;;28;2;0;5;;;56;;1;0;35;0
GIPUZKOA;32;ELGOIBAR;1;6;U;821;460;1;459;1;458;361;130;28;;;59;8;1;5;;;139;;4;0;83;1
GIPUZKOA;32;ELGOIBAR;1;7;A;504;365;0;365;3;362;139;180;23;;;23;0;1;3;;;105;;1;0;25;1
GIPUZKOA;32;ELGOIBAR;1;7;B;532;365;1;364;0;364;167;158;13;;;27;5;0;9;;;113;;0;1;38;0
GIPUZKOA;32;ELGOIBAR;1;8;A;448;275;0;275;0;275;173;97;15;;;44;0;0;6;;;74;;2;0;34;3
GIPUZKOA;32;ELGOIBAR;1;8;B;463;271;0;271;0;271;192;91;18;;;54;7;0;10;;;51;;3;0;37;0
GIPUZKOA;32;ELGOIBAR;1;10;U;881;537;0;537;7;530;344;224;26;;;48;8;2;7;;;157;;0;0;57;1
GIPUZKOA;33;ELGETA;1;1;U;865;619;1;618;2;616;246;227;11;;;21;7;2;2;;;286;;0;0;58;2
GIPUZKOA;34;ESKORIATZA;1;1;A;818;510;2;508;3;505;308;225;15;;;44;4;0;4;;;127;;6;0;79;1
GIPUZKOA;34;ESKORIATZA;1;1;B;770;449;4;445;0;445;321;170;17;;;55;6;1;9;;;110;;2;1;73;1
GIPUZKOA;34;ESKORIATZA;1;2;A;799;526;0;526;4;522;273;201;5;;;27;5;2;0;;;229;;6;0;47;0
GIPUZKOA;34;ESKORIATZA;1;2;B;757;446;0;446;4;442;311;167;15;;;24;2;0;4;;;178;;7;1;42;2
GIPUZKOA;35;EZKIO-ITSASO;1;1;U;484;337;0;337;2;335;147;127;7;;;3;0;1;0;;;164;;0;0;33;0
GIPUZKOA;36;HONDARRIBIA;1;1;A;608;349;0;349;3;346;259;145;21;;;23;2;3;5;;;78;;2;0;67;0
GIPUZKOA;36;HONDARRIBIA;1;1;B;582;310;0;310;1;309;272;137;14;;;19;3;0;7;;;63;;2;0;64;0
GIPUZKOA;36;HONDARRIBIA;1;2;A;595;363;0;363;5;358;232;155;18;;;21;3;1;4;;;82;;3;0;71;0
GIPUZKOA;36;HONDARRIBIA;1;2;B;587;351;1;350;1;349;236;142;12;;;23;2;1;2;;;97;;4;0;65;1
GIPUZKOA;36;HONDARRIBIA;1;3;A;614;379;0;379;4;375;235;217;14;;;24;1;2;4;;;71;;2;2;38;0
GIPUZKOA;36;HONDARRIBIA;1;3;B;569;367;3;364;3;361;202;193;19;;;25;4;3;5;;;74;;1;0;37;0
GIPUZKOA;36;HONDARRIBIA;1;4;U;787;507;3;504;3;501;280;263;42;;;29;3;4;8;;;98;;5;1;46;2
GIPUZKOA;36;HONDARRIBIA;1;5;A;642;411;3;408;1;407;231;219;23;;;20;1;3;6;;;82;;1;1;50;1
GIPUZKOA;36;HONDARRIBIA;1;5;B;667;436;2;434;3;431;231;229;22;;;25;0;1;4;;;91;;3;0;55;1
GIPUZKOA;36;HONDARRIBIA;1;6;A;561;332;0;332;3;329;229;141;8;;;26;2;0;4;;;95;;2;1;49;1
GIPUZKOA;36;HONDARRIBIA;1;6;B;624;377;0;377;0;377;247;184;11;;;21;6;0;4;;;90;;6;1;54;0
GIPUZKOA;36;HONDARRIBIA;1;7;A;742;381;1;380;1;379;361;191;58;;;37;5;0;10;;;45;;1;0;31;1
GIPUZKOA;36;HONDARRIBIA;1;7;B;651;364;0;364;3;361;287;153;45;;;53;1;1;14;;;51;;2;0;40;1
GIPUZKOA;36;HONDARRIBIA;1;8;A;601;378;4;374;2;372;223;180;35;;;30;1;1;9;;;73;;2;1;40;0
GIPUZKOA;36;HONDARRIBIA;1;8;B;670;403;3;400;4;396;267;213;37;;;26;3;0;14;;;56;;2;0;44;1
GIPUZKOA;36;HONDARRIBIA;1;9;A;475;318;1;317;0;317;157;159;37;;;18;3;0;9;;;54;;2;0;34;1
GIPUZKOA;36;HONDARRIBIA;1;9;B;489;331;0;331;3;328;158;164;33;;;30;3;1;3;;;57;;0;0;36;1
GIPUZKOA;36;HONDARRIBIA;1;10;U;597;315;0;315;3;312;282;100;33;;;48;4;1;1;;;53;;5;0;67;0
GIPUZKOA;36;HONDARRIBIA;1;11;A;744;480;5;475;2;473;264;224;9;;;22;2;0;6;;;139;;3;2;65;1
GIPUZKOA;36;HONDARRIBIA;1;11;B;692;429;0;429;6;423;263;201;12;;;20;5;1;3;;;112;;0;0;69;0
GIPUZKOA;36;HONDARRIBIA;1;12;U;758;490;2;488;3;485;268;239;41;;;42;5;3;7;;;79;;2;0;66;1
GIPUZKOA;37;GAINTZA;1;1;U;101;72;0;72;1;71;29;31;0;;;0;1;0;1;;;35;;0;0;3;0
GIPUZKOA;38;GABIRIA;1;1;U;393;281;2;279;1;278;112;121;1;;;1;1;0;0;;;140;;2;0;12;0
GIPUZKOA;39;GETARIA;1;1;U;789;540;0;540;6;534;249;237;4;;;14;3;1;0;;;245;;1;0;27;2
GIPUZKOA;39;GETARIA;1;2;A;658;499;0;499;2;497;159;210;4;;;6;4;0;2;;;237;;0;0;34;0
GIPUZKOA;39;GETARIA;1;2;B;665;501;2;499;4;495;164;203;8;;;10;3;0;1;;;220;;2;0;47;1
GIPUZKOA;40;HERNANI;1;1;U;707;468;1;467;2;465;239;78;4;;;21;1;0;1;;;281;;3;4;69;3
GIPUZKOA;40;HERNANI;1;2;A;458;294;1;293;2;291;164;68;11;;;20;0;0;5;;;155;;2;2;28;0
GIPUZKOA;40;HERNANI;1;2;B;462;300;0;300;0;300;162;72;9;;;22;2;0;1;;;157;;2;1;34;0
GIPUZKOA;40;HERNANI;1;3;U;834;552;2;550;1;549;282;152;13;;;26;0;1;0;;;282;;4;0;71;0
GIPUZKOA;40;HERNANI;1;4;A;711;419;1;418;2;416;292;105;9;;;37;0;1;2;;;174;;1;0;87;0
GIPUZKOA;40;HERNANI;1;4;B;690;392;0;392;6;386;298;85;15;;;58;5;0;4;;;134;;3;0;82;0
GIPUZKOA;40;HERNANI;1;5;A;630;385;0;385;3;382;245;95;11;;;38;2;0;7;;;143;;4;1;81;0
GIPUZKOA;40;HERNANI;1;5;B;586;341;1;340;4;336;245;74;18;;;43;0;0;8;;;118;;4;0;71;0
GIPUZKOA;40;HERNANI;1;6;U;686;411;0;411;5;406;275;111;32;;;67;3;1;8;;;119;;6;1;56;2
GIPUZKOA;40;HERNANI;1;7;U;827;413;2;411;3;408;414;87;25;;;56;9;1;3;;;143;;3;0;78;3
GIPUZKOA;40;HERNANI;1;8;U;852;428;3;425;2;423;424;102;21;;;46;0;0;3;;;176;;1;0;73;1
GIPUZKOA;40;HERNANI;1;9;U;469;292;0;292;4;288;177;52;0;;;0;1;0;0;;;215;;0;0;20;0
GIPUZKOA;40;HERNANI;1;10;A;756;492;1;491;5;486;264;148;14;;;15;3;1;4;;;246;;2;1;51;1
GIPUZKOA;40;HERNANI;1;10;B;700;419;0;419;5;414;281;117;13;;;19;3;1;3;;;204;;0;2;51;1
GIPUZKOA;40;HERNANI;1;11;U;709;421;2;419;3;416;288;95;34;;;47;2;0;4;;;158;;0;0;73;3
GIPUZKOA;40;HERNANI;1;12;U;752;490;1;489;7;482;262;130;23;;;35;3;1;4;;;217;;0;0;69;0
GIPUZKOA;40;HERNANI;1;13;A;777;462;2;460;3;457;315;104;25;;;60;1;0;5;;;186;;1;0;74;1
GIPUZKOA;40;HERNANI;1;13;B;767;484;6;478;3;475;283;103;23;;;59;3;0;3;;;189;;7;2;86;0
GIPUZKOA;40;HERNANI;1;14;U;686;362;1;361;3;358;324;84;25;;;62;4;2;7;;;115;;1;0;57;1
GIPUZKOA;40;HERNANI;1;15;U;696;467;2;465;4;461;229;125;21;;;20;7;1;6;;;198;;0;0;81;2
GIPUZKOA;40;HERNANI;1;16;A;813;505;8;497;5;492;308;119;29;;;45;5;1;6;;;194;;3;0;88;2
GIPUZKOA;40;HERNANI;1;16;B;764;484;5;479;1;478;280;123;19;;;67;1;1;14;;;173;;1;0;79;0
GIPUZKOA;41;HERNIALDE;1;1;U;254;131;0;131;0;131;123;55;1;;;1;1;1;4;;;54;;0;0;14;0
GIPUZKOA;42;IBARRA;1;1;A;650;410;1;409;6;403;240;150;12;;;32;0;0;2;;;143;;1;0;61;2
GIPUZKOA;42;IBARRA;1;1;B;569;338;2;336;1;335;231;101;14;;;32;2;0;5;;;133;;1;0;47;0
GIPUZKOA;42;IBARRA;1;2;A;576;339;2;337;1;336;237;100;9;;;24;1;1;2;;;138;;4;0;55;2
GIPUZKOA;42;IBARRA;1;2;B;554;334;2;332;1;331;220;87;10;;;25;2;0;5;;;144;;3;0;55;0
GIPUZKOA;42;IBARRA;1;3;U;875;547;4;543;8;535;328;201;18;;;35;3;2;2;;;191;;1;0;82;0
GIPUZKOA;43;IDIAZABAL;1;1;A;591;396;0;396;2;394;195;206;7;;;8;0;0;2;;;152;;3;0;16;0
GIPUZKOA;43;IDIAZABAL;1;1;B;521;381;0;381;2;379;140;173;8;;;7;3;0;0;;;154;;1;0;33;0
GIPUZKOA;43;IDIAZABAL;1;1;C;622;392;1;391;3;388;230;177;12;;;14;0;0;0;;;159;;2;0;24;0
GIPUZKOA;44;IKAZTEGIETA;1;1;U;367;247;1;246;0;246;120;88;5;;;4;2;1;0;;;119;;0;0;27;0
GIPUZKOA;45;IRUN;1;1;A;921;570;3;567;6;561;351;212;91;;;92;5;4;13;;;67;;7;1;66;3
GIPUZKOA;45;IRUN;1;1;B;833;514;1;513;4;509;319;172;78;;;73;7;2;26;;;55;;10;0;83;3
GIPUZKOA;45;IRUN;1;2;A;615;387;1;386;3;383;228;139;42;;;58;8;1;15;;;59;;3;0;58;0
GIPUZKOA;45;IRUN;1;2;B;585;332;1;331;2;329;253;128;19;;;34;4;0;7;;;67;;5;0;63;2
GIPUZKOA;45;IRUN;1;3;A;826;523;1;522;2;520;303;193;66;;;78;11;2;11;;;73;;4;0;82;0
GIPUZKOA;45;IRUN;1;3;B;807;479;3;476;5;471;328;171;67;;;65;6;3;19;;;58;;3;0;77;2
GIPUZKOA;45;IRUN;1;4;A;547;347;2;345;1;344;200;132;32;;;45;1;3;15;;;54;;3;0;58;1
GIPUZKOA;45;IRUN;1;4;B;558;338;2;336;2;334;220;112;26;;;52;1;0;4;;;70;;3;0;66;0
GIPUZKOA;45;IRUN;2;1;A;640;368;1;367;2;365;272;128;35;;;56;6;0;4;;;65;;7;0;61;3
GIPUZKOA;45;IRUN;2;1;B;699;370;4;366;1;365;329;113;21;;;75;4;0;5;;;74;;3;0;69;1
GIPUZKOA;45;IRUN;2;2;A;802;409;4;405;2;403;393;117;45;;;74;7;2;17;;;51;;4;0;83;3
GIPUZKOA;45;IRUN;2;2;B;749;383;2;381;2;379;366;96;51;;;79;5;1;12;;;39;;2;1;93;0
GIPUZKOA;45;IRUN;2;3;U;759;399;0;399;1;398;360;141;23;;;32;7;4;10;;;110;;5;0;64;2
GIPUZKOA;45;IRUN;2;4;A;794;378;1;377;7;370;416;120;31;;;57;1;1;9;;;62;;8;0;81;0
GIPUZKOA;45;IRUN;2;4;B;823;432;3;429;0;429;391;139;37;;;75;4;0;11;;;48;;10;0;103;2
GIPUZKOA;45;IRUN;2;5;A;686;387;2;385;2;383;299;145;31;;;42;6;0;8;;;80;;2;0;69;0
GIPUZKOA;45;IRUN;2;5;B;635;354;3;351;3;348;281;122;27;;;41;3;0;12;;;63;;4;0;72;4
GIPUZKOA;45;IRUN;2;6;A;541;340;1;339;2;337;201;127;28;;;47;6;2;6;;;67;;5;0;47;2
GIPUZKOA;45;IRUN;2;6;B;531;325;0;325;0;325;206;106;39;;;57;5;1;13;;;56;;7;0;40;1
GIPUZKOA;45;IRUN;2;7;A;514;295;1;294;0;294;219;101;25;;;56;2;1;8;;;52;;4;0;43;2
GIPUZKOA;45;IRUN;2;7;B;537;332;3;329;2;327;205;100;25;;;87;3;1;8;;;52;;3;0;47;1
GIPUZKOA;45;IRUN;2;8;A;779;446;3;443;1;442;333;150;23;;;87;2;2;13;;;69;;5;0;89;2
GIPUZKOA;45;IRUN;2;8;B;728;386;0;386;5;381;342;109;30;;;70;3;1;5;;;42;;10;0;110;1
GIPUZKOA;45;IRUN;2;9;U;774;476;0;476;3;473;298;166;44;;;78;6;4;17;;;43;;12;0;100;3
GIPUZKOA;45;IRUN;2;10;A;853;545;0;545;2;543;308;181;40;;;106;6;2;8;;;81;;11;1;105;2
GIPUZKOA;45;IRUN;2;10;B;847;518;1;517;2;515;329;154;38;;;94;10;2;10;;;66;;13;0;124;4
GIPUZKOA;45;IRUN;3;1;A;757;451;2;449;4;445;306;155;90;;;63;4;4;20;;;51;;0;0;56;2
GIPUZKOA;45;IRUN;3;1;B;709;438;2;436;0;436;271;142;107;;;55;3;3;23;;;46;;6;0;50;1
GIPUZKOA;45;IRUN;3;2;U;858;462;1;461;2;459;396;105;83;;;118;5;2;6;;;45;;6;0;85;4
GIPUZKOA;45;IRUN;3;3;U;861;427;0;427;4;423;434;115;44;;;97;7;3;19;;;50;;6;0;81;1
GIPUZKOA;45;IRUN;3;4;U;707;330;0;330;4;326;377;80;31;;;91;5;6;10;;;23;;7;1;69;3
GIPUZKOA;45;IRUN;3;5;A;570;308;0;308;3;305;262;80;43;;;78;4;2;6;;;26;;3;0;63;0
GIPUZKOA;45;IRUN;3;5;B;537;281;0;281;0;281;256;61;42;;;72;1;2;9;;;31;;2;0;61;0
GIPUZKOA;45;IRUN;3;6;A;534;324;1;323;3;320;210;110;49;;;61;3;5;20;;;33;;1;0;37;1
GIPUZKOA;45;IRUN;3;6;B;508;292;1;291;2;289;216;80;58;;;49;5;1;22;;;26;;2;0;45;1
GIPUZKOA;45;IRUN;3;7;A;499;286;0;286;2;284;213;90;45;;;82;4;1;8;;;14;;4;1;34;1
GIPUZKOA;45;IRUN;3;7;B;533;281;4;277;2;275;252;66;65;;;63;0;1;6;;;21;;2;0;49;2
GIPUZKOA;45;IRUN;3;8;A;458;242;1;241;1;240;216;69;49;;;63;2;2;8;;;8;;0;0;39;0
GIPUZKOA;45;IRUN;3;8;B;455;235;1;234;2;232;220;52;62;;;59;1;0;4;;;20;;3;0;31;0
GIPUZKOA;45;IRUN;3;9;A;510;286;2;284;2;282;224;96;40;;;52;4;1;4;;;31;;1;1;50;2
GIPUZKOA;45;IRUN;3;9;B;514;290;1;289;0;289;224;77;40;;;64;0;0;9;;;34;;2;0;61;2
GIPUZKOA;45;IRUN;3;10;A;588;343;0;343;2;341;245;81;36;;;118;4;2;12;;;26;;6;1;55;0
GIPUZKOA;45;IRUN;3;10;B;615;358;2;356;1;355;257;68;43;;;116;6;1;10;;;23;;3;0;81;4
GIPUZKOA;45;IRUN;3;11;U;825;504;1;503;0;503;321;136;51;;;115;4;2;16;;;79;;1;0;95;4
GIPUZKOA;45;IRUN;3;12;A;574;321;2;319;1;318;253;80;38;;;106;3;0;14;;;25;;3;0;47;2
GIPUZKOA;45;IRUN;3;12;B;567;315;1;314;2;312;252;90;46;;;75;7;0;12;;;28;;4;0;49;1
GIPUZKOA;45;IRUN;3;13;A;683;353;2;351;1;350;330;97;56;;;92;3;1;19;;;25;;3;2;49;3
GIPUZKOA;45;IRUN;3;13;B;711;357;4;353;1;352;354;93;50;;;94;4;2;23;;;22;;4;0;58;2
GIPUZKOA;45;IRUN;3;14;A;472;242;0;242;1;241;230;55;24;;;66;6;0;6;;;26;;2;0;55;1
GIPUZKOA;45;IRUN;3;14;B;452;222;0;222;1;221;230;51;18;;;70;2;0;6;;;26;;0;0;47;1
GIPUZKOA;45;IRUN;3;15;A;878;503;2;501;9;492;375;141;58;;;120;3;1;11;;;53;;5;0;99;1
GIPUZKOA;45;IRUN;3;15;B;902;526;2;524;2;522;376;135;81;;;127;7;4;19;;;58;;5;1;83;2
GIPUZKOA;45;IRUN;3;16;U;579;267;0;267;0;267;312;63;41;;;68;6;0;7;;;22;;9;0;50;1
GIPUZKOA;45;IRUN;3;17;A;748;437;0;437;9;428;311;150;51;;;84;4;7;21;;;43;;6;0;61;1
GIPUZKOA;45;IRUN;3;17;B;775;425;0;425;7;418;350;156;60;;;86;3;3;14;;;38;;0;0;57;1
GIPUZKOA;45;IRUN;3;18;U;783;458;1;457;1;456;325;119;51;;;145;3;4;21;;;44;;10;0;59;0
GIPUZKOA;45;IRUN;3;19;A;445;246;1;245;1;244;199;96;31;;;29;5;1;8;;;39;;5;0;30;0
GIPUZKOA;45;IRUN;3;19;B;469;275;0;275;4;271;194;97;29;;;32;5;1;9;;;51;;2;1;44;0
GIPUZKOA;45;IRUN;4;1;U;492;252;0;252;5;247;240;48;30;;;68;6;1;7;;;27;;1;0;59;0
GIPUZKOA;45;IRUN;4;2;U;652;352;1;351;2;349;300;66;34;;;123;6;2;14;;;25;;4;0;72;3
GIPUZKOA;45;IRUN;4;3;A;668;348;3;345;1;344;320;96;38;;;82;8;3;8;;;23;;7;0;76;3
GIPUZKOA;45;IRUN;4;3;B;645;311;0;311;2;309;334;81;31;;;71;4;2;7;;;21;;8;0;83;1
GIPUZKOA;45;IRUN;4;4;U;1026;602;2;600;4;596;424;206;56;;;81;5;2;18;;;86;;11;0;128;3
GIPUZKOA;45;IRUN;4;5;A;453;259;3;256;2;254;194;83;25;;;57;1;1;8;;;39;;2;0;36;2
GIPUZKOA;45;IRUN;4;5;B;442;237;0;237;1;236;205;57;25;;;61;2;0;1;;;39;;6;0;44;1
GIPUZKOA;45;IRUN;4;6;A;661;367;0;367;1;366;294;74;29;;;67;1;1;8;;;74;;10;0;102;0
GIPUZKOA;45;IRUN;4;6;B;636;364;0;364;1;363;272;77;26;;;63;2;1;3;;;69;;11;0;110;1
GIPUZKOA;45;IRUN;4;7;U;724;407;0;407;4;403;317;123;29;;;59;4;2;7;;;98;;3;1;73;4
GIPUZKOA;45;IRUN;4;8;A;474;292;3;289;1;288;182;82;26;;;68;3;0;3;;;47;;6;0;53;0
GIPUZKOA;45;IRUN;4;8;B;426;228;3;225;1;224;198;64;25;;;43;3;0;6;;;31;;9;0;42;1
GIPUZKOA;45;IRUN;4;9;A;472;252;1;251;1;250;220;86;20;;;38;1;0;6;;;52;;3;0;42;2
GIPUZKOA;45;IRUN;4;9;B;479;255;0;255;1;254;224;85;20;;;39;1;0;8;;;39;;2;1;59;0
GIPUZKOA;46;IRURA;1;1;A;628;391;0;391;3;388;237;158;4;;;15;0;1;5;;;155;;1;0;49;0
GIPUZKOA;46;IRURA;1;1;B;596;348;2;346;0;346;248;122;9;;;15;4;0;9;;;147;;1;0;38;1
GIPUZKOA;47;ITSASONDO;1;1;U;475;313;3;310;4;306;162;96;4;;;7;0;0;2;;;167;;0;0;29;1
GIPUZKOA;48;LARRAUL;1;1;U;183;117;2;115;0;115;66;23;1;;;3;1;0;0;;;71;;3;0;13;0
GIPUZKOA;49;LAZKAO;1;1;A;738;491;2;489;3;486;247;206;9;;;30;2;0;2;;;172;;2;0;62;1
GIPUZKOA;49;LAZKAO;1;1;B;777;496;3;493;3;490;281;187;19;;;27;2;0;4;;;192;;0;0;59;0
GIPUZKOA;49;LAZKAO;1;2;A;652;402;0;402;2;400;250;125;8;;;33;3;0;3;;;186;;0;1;41;0
GIPUZKOA;49;LAZKAO;1;2;B;707;437;3;434;4;430;270;140;6;;;39;3;0;4;;;174;;3;0;61;0
GIPUZKOA;49;LAZKAO;1;3;A;640;429;0;429;2;427;211;161;8;;;22;2;1;2;;;187;;1;0;42;1
GIPUZKOA;49;LAZKAO;1;3;B;605;398;0;398;3;395;207;144;4;;;15;4;1;2;;;185;;1;0;38;1
GIPUZKOA;50;LEABURU;1;1;U;269;186;0;186;1;185;83;61;1;;;0;1;1;0;;;108;;1;0;12;0
GIPUZKOA;51;LEGAZPI;1;1;A;613;403;1;402;0;402;210;179;16;;;28;0;0;4;;;129;;1;0;43;2
GIPUZKOA;51;LEGAZPI;1;1;B;555;367;1;366;3;363;188;170;12;;;29;1;0;3;;;107;;2;0;37;2
GIPUZKOA;51;LEGAZPI;1;2;A;534;377;3;374;1;373;157;151;12;;;28;0;0;3;;;137;;2;0;40;0
GIPUZKOA;51;LEGAZPI;1;2;B;600;421;4;417;3;414;179;195;24;;;25;1;1;2;;;118;;2;0;46;0
GIPUZKOA;51;LEGAZPI;1;2;C;672;469;5;464;8;456;203;206;14;;;34;1;0;5;;;131;;1;1;62;1
GIPUZKOA;51;LEGAZPI;1;3;U;808;493;0;493;4;489;315;140;28;;;55;3;0;5;;;172;;7;0;77;2
GIPUZKOA;51;LEGAZPI;1;4;U;840;533;1;532;6;526;307;152;23;;;64;3;0;7;;;187;;1;1;87;1
GIPUZKOA;51;LEGAZPI;1;5;A;493;315;1;314;2;312;178;81;27;;;65;3;0;2;;;84;;0;0;50;0
GIPUZKOA;51;LEGAZPI;1;5;B;491;279;0;279;3;276;212;65;27;;;46;3;1;8;;;74;;0;1;51;0
GIPUZKOA;51;LEGAZPI;1;6;U;658;409;1;408;0;408;249;141;23;;;64;1;1;2;;;120;;2;1;50;3
GIPUZKOA;51;LEGAZPI;1;7;A;201;142;0;142;2;140;59;67;0;;;7;0;0;0;;;54;;0;0;12;0
GIPUZKOA;51;LEGAZPI;1;7;B;394;262;1;261;4;257;132;85;5;;;38;1;0;3;;;87;;3;0;34;1
GIPUZKOA;52;LEGORRETA;1;1;A;534;371;3;368;2;366;163;143;11;;;9;0;0;3;;;151;;2;0;45;2
GIPUZKOA;52;LEGORRETA;1;1;B;551;368;2;366;9;357;183;127;6;;;5;1;1;3;;;161;;0;0;51;2
GIPUZKOA;53;LEZO;1;1;A;769;469;2;467;3;464;300;128;10;;;44;3;1;3;;;213;;2;0;60;0
GIPUZKOA;53;LEZO;1;1;B;795;471;2;469;2;467;324;129;14;;;52;1;0;5;;;181;;3;1;81;0
GIPUZKOA;53;LEZO;1;2;U;840;494;0;494;5;489;346;132;20;;;32;4;0;4;;;204;;3;0;90;0
GIPUZKOA;53;LEZO;1;3;A;527;275;0;275;2;273;252;74;7;;;26;1;0;6;;;105;;2;0;52;0
GIPUZKOA;53;LEZO;1;3;B;575;300;2;298;5;293;275;67;13;;;21;5;0;3;;;128;;0;0;56;0
GIPUZKOA;53;LEZO;1;4;A;633;402;0;402;7;395;231;98;13;;;29;1;1;9;;;172;;4;0;68;0
GIPUZKOA;53;LEZO;1;4;B;646;372;1;371;1;370;274;85;11;;;34;1;1;8;;;151;;2;0;77;0
GIPUZKOA;54;LIZARTZA;1;1;U;441;310;1;309;4;305;131;66;0;;;0;0;0;1;;;222;;0;0;16;0
GIPUZKOA;55;ARRASATE/MONDRAGON;1;1;A;493;344;0;344;3;341;149;124;13;;;17;4;1;0;;;131;;2;0;49;0
GIPUZKOA;55;ARRASATE/MONDRAGON;1;1;B;489;306;3;303;2;301;183;109;8;;;12;3;0;2;;;130;;3;0;33;1
GIPUZKOA;55;ARRASATE/MONDRAGON;1;2;A;479;334;0;334;2;332;145;118;15;;;11;1;0;0;;;147;;1;0;39;0
GIPUZKOA;55;ARRASATE/MONDRAGON;1;2;B;519;363;1;362;1;361;156;130;19;;;20;1;0;1;;;147;;0;0;42;1
GIPUZKOA;55;ARRASATE/MONDRAGON;1;3;U;784;518;1;517;0;517;266;218;21;;;33;1;1;5;;;198;;2;0;36;2
GIPUZKOA;55;ARRASATE/MONDRAGON;1;4;U;862;530;3;527;4;523;332;173;13;;;41;4;2;6;;;187;;3;0;94;0
GIPUZKOA;55;ARRASATE/MONDRAGON;1;5;A;677;507;0;507;1;506;170;260;20;;;25;0;1;3;;;162;;0;0;33;2
GIPUZKOA;55;ARRASATE/MONDRAGON;1;5;B;665;486;3;483;2;481;179;221;18;;;24;0;0;5;;;170;;0;0;41;2
GIPUZKOA;55;ARRASATE/MONDRAGON;1;6;A;815;545;4;541;1;540;270;148;15;;;27;4;0;4;;;265;;4;1;70;2
GIPUZKOA;55;ARRASATE/MONDRAGON;1;6;B;780;490;2;488;3;485;290;150;13;;;36;2;1;7;;;191;;1;1;80;3
GIPUZKOA;55;ARRASATE/MONDRAGON;2;1;A;495;343;1;342;0;342;152;119;12;;;32;3;0;8;;;117;;3;0;46;2
GIPUZKOA;55;ARRASATE/MONDRAGON;2;1;B;505;328;1;327;1;326;177;99;7;;;24;5;0;10;;;103;;1;0;75;2
GIPUZKOA;55;ARRASATE/MONDRAGON;2;2;A;481;255;1;254;0;254;226;54;18;;;57;1;0;2;;;53;;2;0;65;2
GIPUZKOA;55;ARRASATE/MONDRAGON;2;2;B;488;270;0;270;1;269;218;71;15;;;53;4;0;4;;;46;;4;0;69;3
GIPUZKOA;55;ARRASATE/MONDRAGON;2;3;U;806;364;2;362;3;359;442;84;30;;;84;2;1;8;;;40;;7;0;100;3
GIPUZKOA;55;ARRASATE/MONDRAGON;2;4;A;532;318;2;316;0;316;214;98;16;;;50;1;0;3;;;109;;4;0;35;0
GIPUZKOA;55;ARRASATE/MONDRAGON;2;4;B;489;292;0;292;1;291;197;87;14;;;47;1;0;5;;;86;;2;0;49;0
GIPUZKOA;55;ARRASATE/MONDRAGON;3;1;U;732;449;1;448;4;444;283;150;48;;;81;0;2;5;;;103;;2;1;52;0
GIPUZKOA;55;ARRASATE/MONDRAGON;3;2;U;736;470;2;468;2;466;266;172;32;;;71;4;1;6;;;95;;6;0;75;4
GIPUZKOA;55;ARRASATE/MONDRAGON;3;3;U;769;406;3;403;1;402;363;107;25;;;65;1;2;2;;;108;;9;0;83;0
GIPUZKOA;55;ARRASATE/MONDRAGON;4;1;A;516;318;0;318;3;315;198;84;13;;;56;2;0;9;;;87;;1;1;61;1
GIPUZKOA;55;ARRASATE/MONDRAGON;4;1;B;516;303;2;301;0;301;213;66;19;;;56;2;0;4;;;88;;4;0;62;0
GIPUZKOA;55;ARRASATE/MONDRAGON;4;2;A;582;361;0;361;2;359;221;123;6;;;38;7;0;1;;;126;;4;0;53;1
GIPUZKOA;55;ARRASATE/MONDRAGON;4;2;B;523;297;1;296;0;296;226;93;21;;;40;2;0;5;;;90;;2;0;42;1
GIPUZKOA;55;ARRASATE/MONDRAGON;4;3;A;617;360;1;359;2;357;257;98;17;;;48;1;3;6;;;96;;2;0;84;2
GIPUZKOA;55;ARRASATE/MONDRAGON;4;3;B;575;294;0;294;0;294;281;81;10;;;47;2;1;3;;;87;;6;0;57;0
GIPUZKOA;55;ARRASATE/MONDRAGON;4;4;A;472;350;2;348;2;346;122;146;5;;;24;0;1;6;;;134;;0;0;28;2
GIPUZKOA;55;ARRASATE/MONDRAGON;4;4;B;443;291;0;291;0;291;152;122;8;;;20;0;0;1;;;108;;3;1;28;0
GIPUZKOA;55;ARRASATE/MONDRAGON;5;1;U;606;232;1;231;0;231;374;104;9;;;6;1;0;0;;;85;;6;0;20;0
GIPUZKOA;56;MUTRIKU;1;1;A;495;352;3;349;2;347;143;150;7;;;2;1;0;1;;;148;;3;0;34;1
GIPUZKOA;56;MUTRIKU;1;1;B;540;354;4;350;2;348;186;155;14;;;12;2;0;2;;;131;;0;1;30;1
GIPUZKOA;56;MUTRIKU;1;2;A;584;416;4;412;4;408;168;211;10;;;3;0;0;2;;;151;;0;0;31;0
GIPUZKOA;56;MUTRIKU;1;2;B;687;459;2;457;3;454;228;199;18;;;13;0;0;2;;;183;;2;0;36;1
GIPUZKOA;56;MUTRIKU;1;3;A;584;351;0;351;2;349;233;135;6;;;11;4;0;1;;;157;;3;0;32;0
GIPUZKOA;56;MUTRIKU;1;3;B;579;336;2;334;6;328;243;115;11;;;15;3;1;3;;;150;;0;0;30;0
GIPUZKOA;56;MUTRIKU;2;1;U;617;367;1;366;4;362;250;177;6;;;2;2;0;6;;;131;;2;0;36;0
GIPUZKOA;57;MUTILOA;1;1;U;195;128;0;128;1;127;67;31;0;;;0;0;0;0;;;80;;1;0;15;0
GIPUZKOA;58;OLABERRIA;1;1;A;345;249;0;249;1;248;96;97;4;;;5;4;1;1;;;98;;3;0;34;1
GIPUZKOA;58;OLABERRIA;1;1;B;411;226;3;223;0;223;185;92;13;;;47;5;0;6;;;29;;2;0;29;0
GIPUZKOA;59;OÑATI;1;1;A;463;331;4;327;1;326;132;162;1;;;8;0;1;0;;;126;;1;0;27;0
GIPUZKOA;59;OÑATI;1;1;B;519;352;0;352;0;352;167;166;8;;;9;2;0;0;;;138;;2;0;27;0
GIPUZKOA;59;OÑATI;1;2;U;784;547;0;547;1;546;237;291;13;;;10;2;0;3;;;194;;0;0;33;0
GIPUZKOA;59;OÑATI;1;3;A;483;324;1;323;0;323;159;133;9;;;18;0;0;0;;;120;;1;0;41;1
GIPUZKOA;59;OÑATI;1;3;B;436;292;0;292;0;292;144;129;8;;;23;0;1;1;;;101;;0;0;29;0
GIPUZKOA;59;OÑATI;1;4;U;870;565;2;563;2;561;305;209;21;;;44;0;0;5;;;235;;0;0;47;0
GIPUZKOA;59;OÑATI;1;5;A;496;334;0;334;1;333;162;138;13;;;13;1;0;3;;;124;;4;0;37;0
GIPUZKOA;59;OÑATI;1;5;B;507;316;0;316;1;315;191;112;5;;;15;0;0;3;;;140;;4;0;36;0
GIPUZKOA;59;OÑATI;1;6;A;850;569;1;568;2;566;281;176;11;;;18;2;0;6;;;278;;3;0;71;1
GIPUZKOA;59;OÑATI;1;6;B;806;524;0;524;2;522;282;162;11;;;17;2;0;3;;;268;;1;0;57;1
GIPUZKOA;59;OÑATI;1;7;A;612;426;3;423;4;419;186;186;9;;;8;3;1;0;;;170;;0;0;42;0
GIPUZKOA;59;OÑATI;1;7;B;578;379;2;377;2;375;199;133;13;;;18;0;0;3;;;167;;2;0;39;0
GIPUZKOA;59;OÑATI;2;1;A;461;299;1;298;0;298;162;146;7;;;4;1;0;0;;;116;;2;1;21;0
GIPUZKOA;59;OÑATI;2;1;B;553;372;0;372;3;369;181;118;7;;;1;1;1;0;;;204;;3;1;32;1
GIPUZKOA;59;OÑATI;2;1;C;453;281;0;281;0;281;172;88;2;;;2;1;0;0;;;173;;1;0;14;0
GIPUZKOA;60;OREXA;1;1;U;89;79;0;79;2;77;10;2;0;;;0;0;0;0;;;74;;0;0;1;0
GIPUZKOA;61;ORIO;1;1;A;662;442;3;439;7;432;220;203;7;;;13;2;0;3;;;149;;2;0;52;1
GIPUZKOA;61;ORIO;1;1;B;621;386;0;386;3;383;235;186;7;;;13;0;1;4;;;124;;0;0;47;1
GIPUZKOA;61;ORIO;1;2;A;516;309;2;307;2;305;207;144;11;;;16;0;0;2;;;100;;2;0;30;0
GIPUZKOA;61;ORIO;1;2;B;607;380;0;380;5;375;227;165;5;;;22;1;1;2;;;140;;3;1;34;1
GIPUZKOA;61;ORIO;1;3;A;907;553;4;549;3;546;354;253;10;;;29;3;0;2;;;195;;1;1;52;0
GIPUZKOA;61;ORIO;1;3;B;969;561;2;559;2;557;408;246;6;;;38;2;1;0;;;209;;1;0;53;1
GIPUZKOA;62;ORMAIZTEGI;1;1;A;501;336;1;335;4;331;165;145;10;;;8;2;0;1;;;143;;1;0;21;0
GIPUZKOA;62;ORMAIZTEGI;1;1;B;475;334;2;332;5;327;141;149;6;;;6;1;2;2;;;132;;0;0;27;2
GIPUZKOA;63;OIARTZUN;1;1;A;740;520;5;515;2;513;220;161;8;;;11;1;0;1;;;269;;2;0;59;1
GIPUZKOA;63;OIARTZUN;1;1;B;719;485;0;485;0;485;234;141;8;;;12;3;0;1;;;250;;1;2;67;0
GIPUZKOA;63;OIARTZUN;1;2;U;868;592;2;590;4;586;276;139;4;;;9;5;0;0;;;353;;1;0;73;2
GIPUZKOA;63;OIARTZUN;1;3;A;558;358;3;355;5;350;200;98;17;;;27;4;1;5;;;138;;2;2;56;0
GIPUZKOA;63;OIARTZUN;1;3;B;559;357;2;355;1;354;202;86;20;;;26;3;0;6;;;147;;2;0;63;1
GIPUZKOA;63;OIARTZUN;1;4;A;745;474;0;474;0;474;271;110;17;;;11;6;0;1;;;254;;1;0;73;1
GIPUZKOA;63;OIARTZUN;1;4;B;715;419;0;419;2;417;296;79;14;;;14;0;1;0;;;245;;0;0;63;1
GIPUZKOA;63;OIARTZUN;1;5;A;574;359;0;359;0;359;215;91;0;;;4;0;0;0;;;243;;0;0;21;0
GIPUZKOA;63;OIARTZUN;1;5;B;269;190;0;190;0;190;79;35;0;;;2;0;0;0;;;128;;0;0;25;0
GIPUZKOA;63;OIARTZUN;1;6;A;533;359;0;359;2;357;174;95;10;;;9;5;0;6;;;189;;2;0;41;0
GIPUZKOA;63;OIARTZUN;1;6;B;478;303;1;302;5;297;175;95;8;;;5;1;0;2;;;151;;2;0;32;1
GIPUZKOA;63;OIARTZUN;1;7;A;640;420;0;420;1;419;220;123;8;;;8;1;0;2;;;244;;2;0;31;0
GIPUZKOA;63;OIARTZUN;1;7;B;625;420;0;420;2;418;205;114;12;;;7;0;0;4;;;239;;3;1;38;0
GIPUZKOA;64;PASAIA;1;1;U;681;416;0;416;3;413;265;129;7;;;15;0;0;1;;;227;;2;0;31;1
GIPUZKOA;64;PASAIA;1;2;A;545;306;0;306;2;304;239;112;13;;;19;0;1;5;;;123;;2;0;29;0
GIPUZKOA;64;PASAIA;1;2;B;550;300;0;300;3;297;250;93;15;;;21;1;0;0;;;130;;1;1;34;1
GIPUZKOA;64;PASAIA;2;1;U;622;368;0;368;2;366;254;135;7;;;23;3;1;0;;;150;;0;1;46;0
GIPUZKOA;64;PASAIA;2;2;U;522;282;0;282;1;281;240;76;17;;;60;2;0;3;;;44;;2;0;76;1
GIPUZKOA;64;PASAIA;2;3;U;565;291;0;291;2;289;274;94;27;;;45;5;1;3;;;48;;2;0;63;1
GIPUZKOA;64;PASAIA;2;9;U;607;361;1;360;6;354;246;123;26;;;37;2;1;4;;;99;;4;0;57;1
GIPUZKOA;64;PASAIA;3;1;A;678;402;4;398;0;398;276;107;23;;;60;2;1;1;;;122;;3;0;78;1
GIPUZKOA;64;PASAIA;3;1;B;650;364;1;363;0;363;286;88;18;;;47;6;1;8;;;114;;3;0;77;1
GIPUZKOA;64;PASAIA;3;2;A;686;435;2;433;1;432;251;159;20;;;54;7;0;2;;;122;;2;0;63;3
GIPUZKOA;64;PASAIA;3;2;B;712;452;4;448;1;447;260;139;31;;;46;1;2;6;;;154;;6;0;61;1
GIPUZKOA;64;PASAIA;3;3;U;1175;710;2;708;4;704;465;203;34;;;102;3;1;9;;;205;;5;0;139;3
GIPUZKOA;64;PASAIA;4;1;U;860;480;0;480;2;478;380;156;33;;;63;12;0;11;;;90;;5;0;106;2
GIPUZKOA;64;PASAIA;4;2;A;453;241;0;241;1;240;212;69;16;;;24;5;2;6;;;56;;1;1;59;1
GIPUZKOA;64;PASAIA;4;2;B;493;272;1;271;0;271;221;82;18;;;38;3;2;3;;;57;;5;0;62;1
GIPUZKOA;64;PASAIA;4;3;U;594;318;4;314;3;311;276;87;41;;;56;4;2;5;;;46;;5;0;64;1
GIPUZKOA;64;PASAIA;4;4;A;598;287;4;283;1;282;311;74;34;;;48;5;0;7;;;46;;5;0;62;1
GIPUZKOA;64;PASAIA;4;4;B;623;335;0;335;0;335;288;75;29;;;78;4;3;7;;;51;;7;0;76;5
GIPUZKOA;64;PASAIA;4;5;U;896;406;2;404;1;403;490;115;47;;;72;9;1;12;;;53;;5;0;86;3
GIPUZKOA;65;SORALUZE-PLACENCIA DE LAS ARMAS;1;1;A;519;353;3;350;1;349;166;124;14;;;42;2;0;7;;;131;;1;0;27;1
GIPUZKOA;65;SORALUZE-PLACENCIA DE LAS ARMAS;1;1;B;503;318;2;316;1;315;185;90;11;;;30;4;2;3;;;138;;1;0;34;2
GIPUZKOA;65;SORALUZE-PLACENCIA DE LAS ARMAS;1;2;U;832;539;1;538;1;537;293;169;40;;;84;0;0;4;;;197;;2;0;39;2
GIPUZKOA;65;SORALUZE-PLACENCIA DE LAS ARMAS;2;1;A;590;372;2;370;1;369;218;130;20;;;47;2;1;3;;;118;;2;0;44;2
GIPUZKOA;65;SORALUZE-PLACENCIA DE LAS ARMAS;2;1;B;563;306;0;306;1;305;257;84;24;;;46;1;0;7;;;94;;0;0;48;1
GIPUZKOA;66;ERREZIL;1;1;U;447;272;1;271;0;271;175;83;1;;;0;0;0;0;;;181;;0;0;6;0
GIPUZKOA;67;ERRENTERIA;1;1;U;503;284;0;284;3;281;219;62;8;;;12;2;0;0;;;148;;2;0;45;2
GIPUZKOA;67;ERRENTERIA;1;2;A;615;374;2;372;2;370;241;83;24;;;56;4;1;7;;;114;;4;0;75;2
GIPUZKOA;67;ERRENTERIA;1;2;B;581;359;3;356;0;356;222;78;19;;;65;1;1;4;;;103;;2;0;83;0
GIPUZKOA;67;ERRENTERIA;1;3;U;683;426;3;423;2;421;257;118;16;;;26;2;0;2;;;196;;1;1;59;0
GIPUZKOA;67;ERRENTERIA;1;4;A;886;487;1;486;2;484;399;118;28;;;79;4;0;3;;;118;;3;0;131;0
GIPUZKOA;67;ERRENTERIA;1;4;B;852;486;2;484;3;481;366;114;33;;;89;4;0;19;;;113;;2;1;105;1
GIPUZKOA;67;ERRENTERIA;1;5;A;584;340;2;338;1;337;244;93;5;;;24;2;0;2;;;149;;1;0;60;1
GIPUZKOA;67;ERRENTERIA;1;5;B;568;359;0;359;3;356;209;81;8;;;31;5;0;6;;;171;;3;0;50;1
GIPUZKOA;67;ERRENTERIA;1;6;A;834;569;0;569;1;568;265;169;25;;;71;4;6;9;;;189;;2;0;93;0
GIPUZKOA;67;ERRENTERIA;1;6;B;792;491;0;491;3;488;301;128;33;;;83;6;1;9;;;173;;0;0;55;0
GIPUZKOA;67;ERRENTERIA;1;7;U;754;426;2;424;7;417;328;98;27;;;104;6;1;9;;;73;;4;0;92;3
GIPUZKOA;67;ERRENTERIA;1;8;U;680;343;4;339;1;338;337;87;20;;;73;4;1;2;;;88;;2;1;58;2
GIPUZKOA;67;ERRENTERIA;1;9;A;655;365;2;363;4;359;290;105;31;;;27;2;0;5;;;129;;3;0;57;0
GIPUZKOA;67;ERRENTERIA;1;9;B;590;373;0;373;4;369;217;95;27;;;36;2;1;7;;;127;;4;0;69;1
GIPUZKOA;67;ERRENTERIA;1;10;U;548;332;1;331;0;331;216;63;8;;;41;2;0;3;;;126;;1;0;85;2
GIPUZKOA;67;ERRENTERIA;1;13;U;730;399;0;399;2;397;331;97;42;;;73;1;1;7;;;89;;3;0;82;2
GIPUZKOA;67;ERRENTERIA;1;14;A;481;229;0;229;5;224;252;47;22;;;43;4;2;5;;;51;;6;0;43;1
GIPUZKOA;67;ERRENTERIA;1;14;B;475;258;0;258;2;256;217;74;14;;;52;4;0;5;;;52;;2;0;53;0
GIPUZKOA;67;ERRENTERIA;1;15;U;854;428;1;427;6;421;426;81;36;;;124;6;0;14;;;59;;2;1;97;1
GIPUZKOA;67;ERRENTERIA;1;16;U;558;285;0;285;1;284;273;51;20;;;105;5;1;4;;;40;;1;0;56;1
GIPUZKOA;67;ERRENTERIA;1;17;U;690;396;2;394;2;392;294;107;8;;;48;2;0;1;;;152;;2;0;71;1
GIPUZKOA;67;ERRENTERIA;1;18;U;631;350;1;349;1;348;281;115;17;;;9;4;3;6;;;153;;3;0;38;0
GIPUZKOA;67;ERRENTERIA;1;19;A;801;429;3;426;1;425;372;92;21;;;79;5;2;11;;;113;;3;0;98;1
GIPUZKOA;67;ERRENTERIA;1;19;B;817;410;4;406;5;401;407;80;23;;;78;6;0;21;;;89;;7;0;95;2
GIPUZKOA;67;ERRENTERIA;1;20;A;471;293;1;292;3;289;178;56;10;;;23;0;0;2;;;143;;3;0;52;0
GIPUZKOA;67;ERRENTERIA;1;20;B;477;296;0;296;1;295;181;79;15;;;28;4;0;7;;;107;;2;0;53;0
GIPUZKOA;67;ERRENTERIA;1;22;A;666;390;0;390;1;389;276;73;21;;;57;1;1;11;;;144;;4;0;76;1
GIPUZKOA;67;ERRENTERIA;1;22;B;670;397;0;397;1;396;273;72;20;;;71;3;1;10;;;134;;2;0;81;2
GIPUZKOA;67;ERRENTERIA;1;23;A;510;293;0;293;1;292;217;82;27;;;54;2;0;4;;;67;;1;0;55;0
GIPUZKOA;67;ERRENTERIA;1;23;B;492;276;0;276;0;276;216;60;26;;;66;0;0;7;;;68;;0;0;48;1
GIPUZKOA;67;ERRENTERIA;1;24;A;485;251;0;251;0;251;234;52;23;;;74;6;0;3;;;39;;1;0;52;1
GIPUZKOA;67;ERRENTERIA;1;24;B;509;266;1;265;0;265;243;40;28;;;85;1;0;4;;;30;;2;0;75;0
GIPUZKOA;67;ERRENTERIA;1;25;A;507;261;1;260;3;257;246;57;20;;;71;2;0;7;;;43;;1;0;56;0
GIPUZKOA;67;ERRENTERIA;1;25;B;509;265;1;264;3;261;244;52;23;;;64;3;1;3;;;46;;5;1;62;1
GIPUZKOA;67;ERRENTERIA;1;26;A;652;351;2;349;1;348;301;82;26;;;95;1;2;6;;;45;;4;0;86;1
GIPUZKOA;67;ERRENTERIA;1;26;B;610;312;0;312;3;309;298;80;34;;;102;2;1;4;;;24;;1;0;59;2
GIPUZKOA;67;ERRENTERIA;1;27;A;658;352;2;350;2;348;306;70;37;;;113;5;3;9;;;36;;1;0;73;1
GIPUZKOA;67;ERRENTERIA;1;27;B;701;384;1;383;1;382;317;68;35;;;121;4;0;15;;;53;;0;0;85;1
GIPUZKOA;67;ERRENTERIA;1;28;A;710;379;0;379;1;378;331;83;30;;;81;7;0;9;;;71;;2;1;92;2
GIPUZKOA;67;ERRENTERIA;1;28;B;753;397;2;395;3;392;356;71;25;;;79;4;0;13;;;81;;1;2;115;1
GIPUZKOA;67;ERRENTERIA;1;29;A;716;357;1;356;1;355;359;90;39;;;60;3;0;7;;;63;;4;0;88;1
GIPUZKOA;67;ERRENTERIA;1;29;B;686;365;1;364;0;364;321;65;32;;;82;9;0;10;;;70;;5;0;91;0
GIPUZKOA;67;ERRENTERIA;1;30;U;869;552;2;550;0;550;317;189;27;;;75;5;2;4;;;145;;2;0;100;1
GIPUZKOA;67;ERRENTERIA;1;32;U;579;303;4;299;0;299;276;41;39;;;116;0;1;16;;;36;;4;0;44;2
GIPUZKOA;67;ERRENTERIA;1;34;U;576;338;0;338;0;338;238;61;21;;;56;3;0;13;;;111;;5;0;67;1
GIPUZKOA;67;ERRENTERIA;1;35;U;631;412;1;411;0;411;219;125;12;;;48;1;0;2;;;163;;4;0;56;0
GIPUZKOA;67;ERRENTERIA;1;36;A;645;422;1;421;3;418;223;99;17;;;78;2;0;13;;;98;;2;0;107;2
GIPUZKOA;67;ERRENTERIA;1;36;B;596;372;0;372;0;372;224;99;16;;;76;3;0;8;;;81;;5;0;84;0
GIPUZKOA;68;LEINTZ-GATZAGA;1;1;U;189;132;3;129;0;129;57;39;0;;;0;0;0;0;;;80;;1;0;9;0
GIPUZKOA;69;DONOSTIA/SAN SEBASTIÁN;1;1;U;564;359;1;358;0;358;205;122;30;;;22;3;0;4;;;123;;0;0;53;1
GIPUZKOA;69;DONOSTIA/SAN SEBASTIÁN;1;2;U;671;434;4;430;1;429;237;172;22;;;31;3;0;2;;;153;;2;0;43;1
GIPUZKOA;69;DONOSTIA/SAN SEBASTIÁN;1;3;U;1067;650;5;645;3;642;417;198;34;;;40;5;0;4;;;269;;2;0;88;2
GIPUZKOA;69;DONOSTIA/SAN SEBASTIÁN;1;5;U;785;545;1;544;6;538;240;217;55;;;37;3;2;5;;;149;;1;0;67;2
GIPUZKOA;69;DONOSTIA/SAN SEBASTIÁN;1;6;U;868;583;0;583;5;578;285;228;75;;;49;3;0;22;;;143;;0;0;58;0
GIPUZKOA;69;DONOSTIA/SAN SEBASTIÁN;1;7;U;606;390;0;390;1;389;216;132;28;;;23;6;1;6;;;138;;2;1;50;2
GIPUZKOA;69;DONOSTIA/SAN SEBASTIÁN;2;1;U;831;596;1;595;2;593;235;257;117;;;57;1;1;15;;;93;;1;0;50;1
GIPUZKOA;69;DONOSTIA/SAN SEBASTIÁN;2;2;U;1202;825;1;824;9;815;377;384;193;;;73;6;4;20;;;72;;5;0;57;1
GIPUZKOA;69;DONOSTIA/SAN SEBASTIÁN;2;4;U;968;639;0;639;3;636;329;285;159;;;60;6;6;14;;;63;;0;0;43;0
GIPUZKOA;69;DONOSTIA/SAN SEBASTIÁN;2;5;U;666;436;3;433;2;431;230;176;88;;;46;5;1;14;;;61;;1;0;38;1
GIPUZKOA;69;DONOSTIA/SAN SEBASTIÁN;2;6;U;919;629;2;627;10;617;290;296;113;;;57;4;0;15;;;80;;1;0;47;4
GIPUZKOA;69;DONOSTIA/SAN SEBASTIÁN;2;7;U;872;611;2;609;1;608;261;273;173;;;35;0;6;25;;;51;;0;0;44;1
GIPUZKOA;69;DONOSTIA/SAN SEBASTIÁN;2;8;U;851;528;0;528;1;527;323;208;101;;;57;3;2;18;;;72;;2;1;62;1
GIPUZKOA;69;DONOSTIA/SAN SEBASTIÁN;2;9;U;741;516;1;515;1;514;225;217;92;;;51;1;4;16;;;90;;3;0;40;0
GIPUZKOA;69;DONOSTIA/SAN SEBASTIÁN;3;1;U;744;545;1;544;4;540;199;208;132;;;67;2;2;13;;;77;;2;0;37;0
GIPUZKOA;69;DONOSTIA/SAN SEBASTIÁN;3;2;U;742;485;1;484;4;480;257;187;94;;;58;2;5;15;;;64;;0;0;54;1
GIPUZKOA;69;DONOSTIA/SAN SEBASTIÁN;3;3;U;772;524;0;524;4;520;248;176;74;;;60;7;7;10;;;108;;1;0;77;0
GIPUZKOA;69;DONOSTIA/SAN SEBASTIÁN;3;4;U;837;544;0;544;2;542;293;198;71;;;57;10;2;17;;;97;;0;1;89;0
GIPUZKOA;69;DONOSTIA/SAN SEBASTIÁN;3;5;U;921;558;0;558;5;553;363;133;59;;;94;6;0;12;;;139;;1;1;104;4
GIPUZKOA;69;DONOSTIA/SAN SEBASTIÁN;3;6;U;629;381;1;380;1;379;248;103;27;;;76;6;3;7;;;95;;1;0;61;0
GIPUZKOA;69;DONOSTIA/SAN SEBASTIÁN;3;7;U;547;360;0;360;5;355;187;110;48;;;41;9;1;9;;;88;;3;0;45;1
GIPUZKOA;69;DONOSTIA/SAN SEBASTIÁN;3;8;U;634;418;0;418;1;417;216;173;53;;;39;0;8;7;;;90;;1;0;44;2
GIPUZKOA;69;DONOSTIA/SAN SEBASTIÁN;3;9;U;807;503;1;502;6;496;304;150;120;;;74;5;1;17;;;62;;0;1;66;0
GIPUZKOA;69;DONOSTIA/SAN SEBASTIÁN;3;10;U;858;581;0;581;5;576;277;205;154;;;74;5;2;16;;;69;;1;0;48;2
GIPUZKOA;69;DONOSTIA/SAN SEBASTIÁN;3;11;U;1004;644;0;644;4;640;360;219;105;;;93;3;2;21;;;94;;4;0;98;1
GIPUZKOA;69;DONOSTIA/SAN SEBASTIÁN;3;12;U;1184;811;1;810;8;802;373;320;192;;;102;7;1;32;;;60;;5;0;81;2
GIPUZKOA;69;DONOSTIA/SAN SEBASTIÁN;3;13;U;930;560;1;559;1;558;370;175;82;;;94;7;0;13;;;95;;4;1;87;0
GIPUZKOA;69;DONOSTIA/SAN SEBASTIÁN;3;14;U;683;436;4;432;6;426;247;146;53;;;76;6;5;9;;;68;;1;0;58;4
GIPUZKOA;69;DONOSTIA/SAN SEBASTIÁN;3;15;U;836;539;3;536;1;535;297;188;92;;;93;5;4;17;;;56;;5;0;75;0
GIPUZKOA;69;DONOSTIA/SAN SEBASTIÁN;3;16;U;868;609;4;605;15;590;259;200;106;;;69;9;2;25;;;80;;2;3;91;3
GIPUZKOA;69;DONOSTIA/SAN SEBASTIÁN;3;17;A;568;386;0;386;4;382;182;135;55;;;57;4;1;12;;;57;;1;0;59;1
GIPUZKOA;69;DONOSTIA/SAN SEBASTIÁN;3;17;B;648;461;1;460;0;460;187;151;71;;;73;4;2;12;;;81;;0;0;65;1
GIPUZKOA;69;DONOSTIA/SAN SEBASTIÁN;3;18;A;624;394;1;393;3;390;230;152;57;;;48;4;0;8;;;63;;0;0;57;1
GIPUZKOA;69;DONOSTIA/SAN SEBASTIÁN;3;18;B;666;402;3;399;4;395;264;129;54;;;57;3;1;13;;;63;;1;0;73;1
GIPUZKOA;69;DONOSTIA/SAN SEBASTIÁN;3;19;A;888;606;0;606;5;601;282;208;70;;;94;4;4;17;;;100;;3;0;99;2
GIPUZKOA;69;DONOSTIA/SAN SEBASTIÁN;3;19;B;879;581;3;578;4;574;298;172;80;;;111;3;0;18;;;106;;1;0;81;2
GIPUZKOA;69;DONOSTIA/SAN SEBASTIÁN;3;20;A;1003;552;1;551;3;548;451;188;49;;;77;8;2;16;;;103;;2;1;99;3
GIPUZKOA;69;DONOSTIA/SAN SEBASTIÁN;3;20;B;960;513;2;511;5;506;447;178;52;;;104;2;0;17;;;80;;5;0;65;3
GIPUZKOA;69;DONOSTIA/SAN SEBASTIÁN;3;21;A;689;434;2;432;5;427;255;108;37;;;67;4;0;9;;;103;;3;0;95;1
GIPUZKOA;69;DONOSTIA/SAN SEBASTIÁN;3;21;B;696;412;2;410;4;406;284;111;35;;;70;4;1;11;;;90;;3;1;79;1
GIPUZKOA;69;DONOSTIA/SAN SEBASTIÁN;3;22;U;616;412;2;410;2;408;204;118;34;;;48;2;0;9;;;101;;4;0;88;4
GIPUZKOA;69;DONOSTIA/SAN SEBASTIÁN;3;24;U;1086;693;0;693;3;690;393;291;101;;;96;4;7;20;;;92;;0;0;77;2
GIPUZKOA;69;DONOSTIA/SAN SEBASTIÁN;3;25;A;905;599;1;598;4;594;306;230;88;;;79;6;2;18;;;86;;5;0;79;1
GIPUZKOA;69;DONOSTIA/SAN SEBASTIÁN;3;25;B;857;579;1;578;7;571;278;240;82;;;76;9;3;18;;;75;;2;0;66;0
GIPUZKOA;69;DONOSTIA/SAN SEBASTIÁN;3;26;U;866;593;0;593;9;584;273;210;95;;;99;7;1;8;;;97;;3;0;63;1
GIPUZKOA;69;DONOSTIA/SAN SEBASTIÁN;3;27;A;626;423;2;421;4;417;203;156;47;;;64;4;1;13;;;69;;0;0;63;0
GIPUZKOA;69;DONOSTIA/SAN SEBASTIÁN;3;27;B;619;396;0;396;1;395;223;147;57;;;66;1;2;17;;;47;;0;0;55;3
GIPUZKOA;69;DONOSTIA/SAN SEBASTIÁN;3;28;U;764;457;1;456;3;453;307;134;44;;;92;7;1;11;;;85;;1;2;75;1
GIPUZKOA;69;DONOSTIA/SAN SEBASTIÁN;3;29;U;656;450;2;448;4;444;206;154;92;;;60;5;0;14;;;63;;1;0;54;1
GIPUZKOA;69;DONOSTIA/SAN SEBASTIÁN;3;30;A;587;404;1;403;4;399;183;144;73;;;53;3;0;13;;;54;;0;0;56;3
GIPUZKOA;69;DONOSTIA/SAN SEBASTIÁN;3;30;B;607;420;3;417;5;412;187;149;70;;;55;1;3;12;;;52;;2;0;67;1
GIPUZKOA;69;DONOSTIA/SAN SEBASTIÁN;3;31;A;928;622;1;621;2;619;306;212;61;;;95;2;0;19;;;115;;5;1;107;2
GIPUZKOA;69;DONOSTIA/SAN SEBASTIÁN;3;31;B;911;557;1;556;1;555;354;189;68;;;81;8;1;25;;;85;;5;1;92;0
GIPUZKOA;69;DONOSTIA/SAN SEBASTIÁN;3;32;A;671;408;0;408;2;406;263;129;33;;;57;5;0;11;;;80;;1;0;89;1
GIPUZKOA;69;DONOSTIA/SAN SEBASTIÁN;3;32;B;724;471;1;470;1;469;253;181;34;;;59;12;1;18;;;78;;2;0;82;2
GIPUZKOA;69;DONOSTIA/SAN SEBASTIÁN;4;1;U;1032;637;3;634;6;628;395;252;106;;;66;5;2;15;;;90;;7;0;84;1
GIPUZKOA;69;DONOSTIA/SAN SEBASTIÁN;4;2;U;835;540;2;538;8;530;295;222;91;;;54;2;2;18;;;74;;0;0;64;3
GIPUZKOA;69;DONOSTIA/SAN SEBASTIÁN;4;3;U;830;555;1;554;3;551;275;183;73;;;82;5;0;9;;;113;;0;0;86;0
GIPUZKOA;69;DONOSTIA/SAN SEBASTIÁN;4;4;U;847;591;1;590;10;580;256;225;94;;;68;5;2;23;;;88;;0;0;72;3
GIPUZKOA;69;DONOSTIA/SAN SEBASTIÁN;4;5;U;641;401;2;399;5;394;240;156;61;;;45;3;0;18;;;52;;1;0;57;1
GIPUZKOA;69;DONOSTIA/SAN SEBASTIÁN;4;6;U;767;503;3;500;4;496;264;189;78;;;58;5;2;13;;;79;;4;0;68;0
GIPUZKOA;69;DONOSTIA/SAN SEBASTIÁN;4;7;A;725;437;0;437;5;432;288;146;39;;;51;6;4;8;;;98;;1;0;77;2
GIPUZKOA;69;DONOSTIA/SAN SEBASTIÁN;4;7;B;698;435;0;435;5;430;263;113;37;;;55;3;3;6;;;129;;4;0;80;0
GIPUZKOA;69;DONOSTIA/SAN SEBASTIÁN;4;8;A;643;376;0;376;1;375;267;112;18;;;47;4;2;15;;;104;;2;0;67;4
GIPUZKOA;69;DONOSTIA/SAN SEBASTIÁN;4;8;B;643;366;1;365;3;362;277;111;24;;;48;7;1;13;;;74;;4;0;78;2
GIPUZKOA;69;DONOSTIA/SAN SEBASTIÁN;4;9;U;895;474;1;473;2;471;421;120;34;;;80;9;0;12;;;121;;1;0;94;0
GIPUZKOA;69;DONOSTIA/SAN SEBASTIÁN;4;10;A;748;489;0;489;4;485;259;153;46;;;70;8;0;7;;;94;;2;0;103;2
GIPUZKOA;69;DONOSTIA/SAN SEBASTIÁN;4;10;B;697;456;1;455;1;454;241;123;47;;;70;6;0;14;;;98;;0;0;95;1
GIPUZKOA;69;DONOSTIA/SAN SEBASTIÁN;4;11;U;856;529;4;525;6;519;327;102;29;;;62;7;4;4;;;195;;0;0;115;1
GIPUZKOA;69;DONOSTIA/SAN SEBASTIÁN;4;12;U;1068;691;2;689;1;688;377;195;59;;;103;9;0;14;;;210;;3;0;89;6
GIPUZKOA;69;DONOSTIA/SAN SEBASTIÁN;4;13;U;1252;807;1;806;3;803;445;200;59;;;96;6;1;18;;;242;;4;0;175;2
GIPUZKOA;69;DONOSTIA/SAN SEBASTIÁN;4;14;A;641;345;1;344;0;344;296;79;48;;;38;3;0;7;;;111;;1;0;55;2
GIPUZKOA;69;DONOSTIA/SAN SEBASTIÁN;4;14;B;630;319;1;318;3;315;311;78;47;;;33;8;3;6;;;90;;2;0;48;0
GIPUZKOA;69;DONOSTIA/SAN SEBASTIÁN;4;15;U;973;528;2;526;1;525;445;147;59;;;67;3;2;9;;;153;;0;0;82;3
GIPUZKOA;69;DONOSTIA/SAN SEBASTIÁN;4;16;U;663;385;1;384;2;382;278;85;30;;;63;4;3;15;;;111;;4;0;65;2
GIPUZKOA;69;DONOSTIA/SAN SEBASTIÁN;4;17;U;1045;619;0;619;2;617;426;202;52;;;94;2;0;12;;;162;;4;0;89;0
GIPUZKOA;69;DONOSTIA/SAN SEBASTIÁN;4;18;U;1146;696;2;694;4;690;450;189;65;;;109;12;2;17;;;170;;7;0;111;8
GIPUZKOA;69;DONOSTIA/SAN SEBASTIÁN;4;19;U;705;452;1;451;5;446;253;116;54;;;54;0;1;18;;;135;;2;0;64;2
GIPUZKOA;69;DONOSTIA/SAN SEBASTIÁN;4;20;U;840;425;1;424;2;422;415;85;34;;;72;6;0;9;;;101;;3;1;111;0
GIPUZKOA;69;DONOSTIA/SAN SEBASTIÁN;5;1;U;869;587;1;586;6;580;282;244;80;;;70;6;1;14;;;99;;0;0;66;0
GIPUZKOA;69;DONOSTIA/SAN SEBASTIÁN;5;2;U;1089;711;3;708;3;705;378;237;57;;;95;5;5;14;;;177;;1;0;112;2
GIPUZKOA;69;DONOSTIA/SAN SEBASTIÁN;5;3;U;840;565;0;565;4;561;275;178;52;;;91;6;2;15;;;109;;3;0;103;2
GIPUZKOA;69;DONOSTIA/SAN SEBASTIÁN;5;4;U;755;452;0;452;3;449;303;166;41;;;48;8;1;11;;;102;;0;0;71;1
GIPUZKOA;69;DONOSTIA/SAN SEBASTIÁN;5;5;U;1020;634;1;633;2;631;386;227;75;;;82;8;3;13;;;127;;1;0;92;3
GIPUZKOA;69;DONOSTIA/SAN SEBASTIÁN;5;6;U;742;475;1;474;1;473;267;183;38;;;64;4;1;9;;;100;;3;1;69;1
GIPUZKOA;69;DONOSTIA/SAN SEBASTIÁN;5;7;U;641;362;0;362;0;362;279;106;17;;;42;5;1;6;;;118;;0;0;67;0
GIPUZKOA;69;DONOSTIA/SAN SEBASTIÁN;5;8;A;681;472;2;470;3;467;209;159;54;;;56;2;1;8;;;96;;1;0;90;0
GIPUZKOA;69;DONOSTIA/SAN SEBASTIÁN;5;8;B;703;457;1;456;4;452;246;146;55;;;67;4;0;11;;;106;;2;1;60;0
GIPUZKOA;69;DONOSTIA/SAN SEBASTIÁN;5;9;U;924;637;1;636;5;631;287;266;89;;;86;3;0;10;;;95;;0;0;82;0
GIPUZKOA;69;DONOSTIA/SAN SEBASTIÁN;5;10;U;902;613;1;612;2;610;289;199;87;;;84;4;0;18;;;139;;3;0;75;1
GIPUZKOA;69;DONOSTIA/SAN SEBASTIÁN;5;11;U;571;370;1;369;3;366;201;142;44;;;37;0;0;7;;;76;;2;1;57;0
GIPUZKOA;69;DONOSTIA/SAN SEBASTIÁN;5;12;A;703;453;1;452;4;448;250;183;68;;;75;2;0;13;;;52;;0;0;54;1
GIPUZKOA;69;DONOSTIA/SAN SEBASTIÁN;5;12;B;793;531;2;529;4;525;262;187;76;;;76;0;2;20;;;74;;1;0;89;0
GIPUZKOA;69;DONOSTIA/SAN SEBASTIÁN;5;13;U;993;590;1;589;6;583;403;175;75;;;69;3;0;20;;;144;;2;0;95;0
GIPUZKOA;69;DONOSTIA/SAN SEBASTIÁN;5;14;A;710;444;1;443;6;437;266;148;66;;;30;2;2;7;;;105;;0;0;77;0
GIPUZKOA;69;DONOSTIA/SAN SEBASTIÁN;5;14;B;696;443;2;441;0;441;253;145;62;;;39;9;0;13;;;107;;1;0;63;2
GIPUZKOA;69;DONOSTIA/SAN SEBASTIÁN;6;1;U;838;572;3;569;1;568;266;247;178;;;39;4;5;19;;;34;;2;2;38;0
GIPUZKOA;69;DONOSTIA/SAN SEBASTIÁN;6;2;U;1071;735;3;732;6;726;336;306;102;;;57;4;5;13;;;161;;5;0;72;1
GIPUZKOA;69;DONOSTIA/SAN SEBASTIÁN;6;3;U;1020;655;1;654;2;652;365;237;41;;;52;1;0;17;;;202;;3;0;95;4
GIPUZKOA;69;DONOSTIA/SAN SEBASTIÁN;6;4;A;761;501;1;500;0;500;260;159;33;;;53;6;3;15;;;155;;3;0;73;0
GIPUZKOA;69;DONOSTIA/SAN SEBASTIÁN;6;4;B;797;509;3;506;2;504;288;157;26;;;68;12;3;4;;;147;;4;0;83;0
GIPUZKOA;69;DONOSTIA/SAN SEBASTIÁN;6;5;A;681;438;0;438;2;436;243;165;33;;;43;3;0;8;;;126;;1;2;54;1
GIPUZKOA;69;DONOSTIA/SAN SEBASTIÁN;6;5;B;641;428;0;428;3;425;213;135;54;;;39;1;3;6;;;134;;0;0;53;0
GIPUZKOA;69;DONOSTIA/SAN SEBASTIÁN;6;6;U;944;622;3;619;4;615;322;211;79;;;58;3;1;11;;;164;;2;0;86;0
GIPUZKOA;69;DONOSTIA/SAN SEBASTIÁN;6;7;A;803;552;2;550;2;548;251;247;152;;;31;1;7;25;;;55;;0;1;28;1
GIPUZKOA;69;DONOSTIA/SAN SEBASTIÁN;6;7;B;878;570;3;567;3;564;308;248;160;;;44;4;1;18;;;49;;3;0;35;2
GIPUZKOA;69;DONOSTIA/SAN SEBASTIÁN;6;8;U;1192;737;1;736;4;732;455;226;73;;;85;7;8;15;;;158;;5;0;152;3
GIPUZKOA;69;DONOSTIA/SAN SEBASTIÁN;6;9;U;630;364;2;362;1;361;266;124;48;;;34;1;0;15;;;77;;2;0;58;2
GIPUZKOA;69;DONOSTIA/SAN SEBASTIÁN;6;10;U;1012;648;1;647;2;645;364;274;57;;;72;4;0;14;;;152;;4;0;68;0
GIPUZKOA;69;DONOSTIA/SAN SEBASTIÁN;6;11;U;978;682;0;682;2;680;296;283;193;;;90;2;1;26;;;48;;2;0;35;0
GIPUZKOA;69;DONOSTIA/SAN SEBASTIÁN;6;12;A;1170;756;1;755;4;751;414;231;58;;;74;1;3;13;;;254;;8;0;109;0
GIPUZKOA;69;DONOSTIA/SAN SEBASTIÁN;6;12;B;225;164;0;164;0;164;61;28;0;;;3;0;0;0;;;108;;0;0;25;0
GIPUZKOA;69;DONOSTIA/SAN SEBASTIÁN;6;13;U;698;485;0;485;3;482;213;163;13;;;32;2;1;11;;;208;;1;0;49;2
GIPUZKOA;69;DONOSTIA/SAN SEBASTIÁN;6;14;A;732;491;0;491;8;483;241;213;87;;;58;2;1;15;;;59;;2;0;45;1
GIPUZKOA;69;DONOSTIA/SAN SEBASTIÁN;6;14;B;696;482;1;481;4;477;214;190;79;;;63;3;0;30;;;61;;1;0;50;0
GIPUZKOA;69;DONOSTIA/SAN SEBASTIÁN;6;15;U;837;551;0;551;7;544;286;155;49;;;12;5;2;10;;;269;;0;2;38;2
GIPUZKOA;69;DONOSTIA/SAN SEBASTIÁN;6;16;A;898;566;0;566;3;563;332;235;66;;;64;4;2;20;;;88;;5;0;78;1
GIPUZKOA;69;DONOSTIA/SAN SEBASTIÁN;6;16;B;839;524;3;521;3;518;315;202;79;;;77;2;2;20;;;61;;6;2;67;0
GIPUZKOA;69;DONOSTIA/SAN SEBASTIÁN;6;17;U;877;586;0;586;7;579;291;240;102;;;64;7;4;12;;;73;;4;0;72;1
GIPUZKOA;69;DONOSTIA/SAN SEBASTIÁN;6;18;A;734;518;0;518;4;514;216;247;100;;;54;4;3;13;;;45;;0;0;46;2
GIPUZKOA;69;DONOSTIA/SAN SEBASTIÁN;6;18;B;796;553;0;553;1;552;243;248;129;;;64;2;3;21;;;50;;1;0;31;3
GIPUZKOA;69;DONOSTIA/SAN SEBASTIÁN;6;19;A;665;435;1;434;5;429;230;150;64;;;52;3;1;16;;;80;;1;0;61;1
GIPUZKOA;69;DONOSTIA/SAN SEBASTIÁN;6;19;B;726;465;1;464;0;464;261;178;53;;;70;7;0;15;;;73;;3;0;65;0
GIPUZKOA;69;DONOSTIA/SAN SEBASTIÁN;6;20;U;885;603;3;600;6;594;282;254;111;;;58;5;3;25;;;66;;1;0;71;0
GIPUZKOA;69;DONOSTIA/SAN SEBASTIÁN;6;21;A;730;525;3;522;0;522;205;224;90;;;47;1;3;15;;;84;;1;0;56;1
GIPUZKOA;69;DONOSTIA/SAN SEBASTIÁN;6;21;B;697;468;6;462;4;458;229;190;80;;;55;2;1;17;;;70;;1;1;41;0
GIPUZKOA;69;DONOSTIA/SAN SEBASTIÁN;6;22;A;661;470;0;470;5;465;191;148;40;;;45;3;5;11;;;117;;3;0;92;1
GIPUZKOA;69;DONOSTIA/SAN SEBASTIÁN;6;22;B;589;405;3;402;9;393;184;140;24;;;51;7;0;7;;;95;;2;0;65;2
GIPUZKOA;69;DONOSTIA/SAN SEBASTIÁN;6;23;A;622;380;1;379;3;376;242;118;21;;;46;3;3;3;;;104;;2;1;75;0
GIPUZKOA;69;DONOSTIA/SAN SEBASTIÁN;6;23;B;663;433;1;432;2;430;230;106;26;;;75;7;1;12;;;103;;5;2;93;0
GIPUZKOA;69;DONOSTIA/SAN SEBASTIÁN;6;24;A;698;492;0;492;9;483;206;245;98;;;38;13;3;14;;;49;;0;0;23;0
GIPUZKOA;69;DONOSTIA/SAN SEBASTIÁN;6;24;B;755;520;1;519;9;510;235;256;100;;;51;2;3;9;;;56;;0;1;32;0
GIPUZKOA;69;DONOSTIA/SAN SEBASTIÁN;6;25;A;927;560;1;559;3;556;367;186;50;;;65;3;0;12;;;128;;3;0;105;4
GIPUZKOA;69;DONOSTIA/SAN SEBASTIÁN;6;25;B;882;519;2;517;4;513;363;167;53;;;73;4;4;17;;;110;;5;0;79;1
GIPUZKOA;69;DONOSTIA/SAN SEBASTIÁN;6;26;A;713;539;0;539;8;531;174;201;50;;;66;5;1;10;;;127;;1;0;69;1
GIPUZKOA;69;DONOSTIA/SAN SEBASTIÁN;6;26;B;619;457;1;456;7;449;162;176;39;;;67;3;2;13;;;92;;2;0;53;2
GIPUZKOA;69;DONOSTIA/SAN SEBASTIÁN;6;27;U;708;456;0;456;4;452;252;206;108;;;49;2;3;14;;;37;;2;0;31;0
GIPUZKOA;69;DONOSTIA/SAN SEBASTIÁN;6;28;U;1150;713;6;707;2;705;437;239;95;;;96;16;6;22;;;118;;4;0;109;0
GIPUZKOA;69;DONOSTIA/SAN SEBASTIÁN;6;29;U;1153;739;0;739;6;733;414;241;91;;;89;12;0;27;;;145;;2;1;123;2
GIPUZKOA;69;DONOSTIA/SAN SEBASTIÁN;6;30;U;1181;789;1;788;8;780;392;312;75;;;86;3;0;21;;;182;;1;1;99;0
GIPUZKOA;69;DONOSTIA/SAN SEBASTIÁN;7;1;A;736;394;0;394;3;391;342;105;36;;;115;4;2;13;;;42;;2;1;70;1
GIPUZKOA;69;DONOSTIA/SAN SEBASTIÁN;7;1;B;750;434;1;433;2;431;316;91;36;;;137;8;4;8;;;58;;2;0;85;2
GIPUZKOA;69;DONOSTIA/SAN SEBASTIÁN;7;2;A;704;419;1;418;2;416;285;85;40;;;133;3;3;12;;;43;;4;0;92;1
GIPUZKOA;69;DONOSTIA/SAN SEBASTIÁN;7;2;B;656;398;0;398;4;394;258;103;35;;;123;2;2;7;;;33;;2;0;85;2
GIPUZKOA;69;DONOSTIA/SAN SEBASTIÁN;7;3;U;1092;645;0;645;4;641;447;227;86;;;71;4;0;21;;;124;;1;0;106;1
GIPUZKOA;69;DONOSTIA/SAN SEBASTIÁN;7;4;U;660;384;2;382;3;379;276;86;30;;;55;11;1;11;;;92;;3;0;88;2
GIPUZKOA;69;DONOSTIA/SAN SEBASTIÁN;7;5;U;1009;543;2;541;6;535;466;116;42;;;82;9;1;6;;;139;;7;1;132;0
GIPUZKOA;69;DONOSTIA/SAN SEBASTIÁN;7;6;U;1026;592;0;592;4;588;434;164;44;;;86;10;4;8;;;152;;4;0;116;0
GIPUZKOA;69;DONOSTIA/SAN SEBASTIÁN;7;7;U;1153;664;1;663;5;658;489;171;47;;;108;4;3;23;;;159;;5;1;137;0
GIPUZKOA;69;DONOSTIA/SAN SEBASTIÁN;7;8;U;656;357;1;356;2;354;299;103;26;;;49;5;0;6;;;104;;2;1;58;0
GIPUZKOA;69;DONOSTIA/SAN SEBASTIÁN;7;9;U;581;308;0;308;3;305;273;96;26;;;42;4;2;6;;;65;;2;0;62;0
GIPUZKOA;69;DONOSTIA/SAN SEBASTIÁN;7;10;U;926;571;4;567;5;562;355;198;94;;;82;7;1;28;;;84;;0;0;68;0
GIPUZKOA;69;DONOSTIA/SAN SEBASTIÁN;7;11;U;792;439;1;438;3;435;353;95;40;;;98;7;2;20;;;92;;0;0;81;0
GIPUZKOA;69;DONOSTIA/SAN SEBASTIÁN;7;12;U;706;358;5;353;1;352;348;83;38;;;85;5;0;6;;;66;;1;0;67;1
GIPUZKOA;69;DONOSTIA/SAN SEBASTIÁN;7;13;U;826;477;7;470;4;466;349;121;67;;;101;5;0;10;;;75;;1;0;86;0
GIPUZKOA;69;DONOSTIA/SAN SEBASTIÁN;7;14;U;1136;539;5;534;1;533;597;138;58;;;114;5;1;11;;;82;;9;0;111;4
GIPUZKOA;69;DONOSTIA/SAN SEBASTIÁN;7;15;A;710;434;0;434;2;432;276;138;55;;;62;7;4;13;;;71;;3;0;77;2
GIPUZKOA;69;DONOSTIA/SAN SEBASTIÁN;7;15;B;694;426;0;426;2;424;268;116;55;;;79;1;0;12;;;76;;2;0;80;3
GIPUZKOA;69;DONOSTIA/SAN SEBASTIÁN;7;16;U;766;412;0;412;5;407;354;97;27;;;85;6;2;17;;;78;;8;1;84;2
GIPUZKOA;69;DONOSTIA/SAN SEBASTIÁN;7;17;U;1006;503;1;502;4;498;503;102;39;;;130;3;2;8;;;101;;5;0;105;3
GIPUZKOA;69;DONOSTIA/SAN SEBASTIÁN;7;18;A;886;489;1;488;1;487;397;135;42;;;100;7;0;8;;;83;;5;1;104;2
GIPUZKOA;69;DONOSTIA/SAN SEBASTIÁN;7;18;B;935;478;2;476;1;475;457;111;27;;;120;5;0;12;;;96;;9;1;93;1
GIPUZKOA;69;DONOSTIA/SAN SEBASTIÁN;7;19;U;824;416;1;415;4;411;408;84;52;;;134;7;4;6;;;41;;0;0;83;0
GIPUZKOA;69;DONOSTIA/SAN SEBASTIÁN;7;20;A;778;380;0;380;1;379;398;96;31;;;61;5;1;6;;;84;;0;0;93;2
GIPUZKOA;69;DONOSTIA/SAN SEBASTIÁN;7;20;B;747;383;2;381;3;378;364;111;27;;;63;7;2;13;;;73;;0;0;79;3
GIPUZKOA;69;DONOSTIA/SAN SEBASTIÁN;7;21;U;527;275;1;274;2;272;252;57;41;;;86;5;0;1;;;35;;0;0;47;0
GIPUZKOA;69;DONOSTIA/SAN SEBASTIÁN;7;22;U;777;474;1;473;5;468;303;119;48;;;141;7;4;8;;;53;;0;0;87;1
GIPUZKOA;69;DONOSTIA/SAN SEBASTIÁN;7;23;U;1064;540;5;535;3;532;524;152;28;;;62;8;0;11;;;156;;4;0;109;2
GIPUZKOA;69;DONOSTIA/SAN SEBASTIÁN;7;24;A;651;331;1;330;0;330;320;83;25;;;90;5;1;3;;;52;;1;0;68;2
GIPUZKOA;69;DONOSTIA/SAN SEBASTIÁN;7;24;B;678;338;3;335;3;332;340;81;37;;;89;2;0;6;;;45;;0;0;69;3
GIPUZKOA;69;DONOSTIA/SAN SEBASTIÁN;7;25;U;517;270;0;270;3;267;247;58;23;;;89;5;1;5;;;30;;2;0;54;0
GIPUZKOA;69;DONOSTIA/SAN SEBASTIÁN;7;26;U;630;353;2;351;3;348;277;120;30;;;72;4;2;10;;;52;;1;0;56;1
GIPUZKOA;69;DONOSTIA/SAN SEBASTIÁN;7;27;A;835;496;1;495;1;494;339;134;46;;;73;3;1;8;;;129;;1;0;97;2
GIPUZKOA;69;DONOSTIA/SAN SEBASTIÁN;7;27;B;842;485;2;483;4;479;357;132;46;;;69;2;2;10;;;117;;0;0;99;2
GIPUZKOA;69;DONOSTIA/SAN SEBASTIÁN;7;28;U;926;516;0;516;4;512;410;121;36;;;99;8;1;10;;;97;;6;1;132;1
GIPUZKOA;69;DONOSTIA/SAN SEBASTIÁN;7;30;U;1151;608;0;608;8;600;543;130;55;;;134;11;3;9;;;101;;3;3;150;1
GIPUZKOA;69;DONOSTIA/SAN SEBASTIÁN;7;31;A;789;477;0;477;4;473;312;128;62;;;70;7;0;16;;;84;;0;0;105;1
GIPUZKOA;69;DONOSTIA/SAN SEBASTIÁN;7;31;B;764;457;2;455;3;452;307;105;48;;;85;5;1;13;;;70;;4;0;119;2
GIPUZKOA;69;DONOSTIA/SAN SEBASTIÁN;7;32;U;751;373;2;371;2;369;378;80;40;;;98;7;1;14;;;39;;2;0;88;0
GIPUZKOA;69;DONOSTIA/SAN SEBASTIÁN;7;33;A;837;529;1;528;3;525;308;146;39;;;64;13;4;16;;;108;;6;0;126;3
GIPUZKOA;69;DONOSTIA/SAN SEBASTIÁN;7;33;B;851;509;0;509;6;503;342;111;40;;;83;9;2;18;;;117;;2;0;120;1
GIPUZKOA;69;DONOSTIA/SAN SEBASTIÁN;7;34;U;841;517;1;516;8;508;324;114;30;;;72;5;2;7;;;151;;1;1;123;2
GIPUZKOA;70;SEGURA;1;1;A;501;361;1;360;2;358;140;143;3;;;4;0;0;4;;;185;;0;0;19;0
GIPUZKOA;70;SEGURA;1;1;B;594;428;3;425;2;423;166;177;1;;;3;0;0;1;;;213;;0;0;26;2
GIPUZKOA;71;TOLOSA;1;1;U;562;338;1;337;2;335;224;113;5;;;27;3;0;8;;;114;;3;0;62;0
GIPUZKOA;71;TOLOSA;1;2;U;532;324;1;323;1;322;208;93;10;;;24;0;0;3;;;132;;1;0;57;2
GIPUZKOA;71;TOLOSA;1;3;U;838;512;3;509;0;509;326;156;15;;;27;8;0;3;;;212;;4;0;82;2
GIPUZKOA;71;TOLOSA;1;4;A;630;383;2;381;2;379;247;132;10;;;24;2;0;2;;;149;;2;0;58;0
GIPUZKOA;71;TOLOSA;1;4;B;616;385;0;385;0;385;231;136;20;;;34;3;0;5;;;131;;2;0;53;1
GIPUZKOA;71;TOLOSA;2;1;U;838;588;2;586;8;578;250;275;55;;;27;2;1;4;;;154;;0;0;60;0
GIPUZKOA;71;TOLOSA;2;2;A;726;479;2;477;2;475;247;234;25;;;26;1;1;1;;;125;;0;0;62;0
GIPUZKOA;71;TOLOSA;2;2;B;707;482;0;482;1;481;225;222;20;;;18;1;2;8;;;153;;0;0;57;0
GIPUZKOA;71;TOLOSA;2;3;U;772;463;2;461;2;459;309;155;8;;;22;1;0;4;;;227;;0;1;40;1
GIPUZKOA;71;TOLOSA;2;4;A;468;330;0;330;5;325;138;153;18;;;13;2;0;2;;;97;;0;0;40;0
GIPUZKOA;71;TOLOSA;2;4;B;463;319;2;317;2;315;144;141;30;;;19;1;0;3;;;81;;0;0;39;1
GIPUZKOA;71;TOLOSA;2;5;U;895;643;2;641;3;638;252;375;33;;;22;2;2;7;;;146;;1;0;50;0
GIPUZKOA;71;TOLOSA;3;1;A;669;443;0;443;0;443;226;171;14;;;23;3;0;3;;;170;;4;0;53;2
GIPUZKOA;71;TOLOSA;3;1;B;632;375;0;375;2;373;257;163;10;;;28;0;1;2;;;121;;3;0;44;1
GIPUZKOA;71;TOLOSA;3;1;C;579;368;0;368;1;367;211;155;11;;;22;1;4;4;;;121;;2;0;46;1
GIPUZKOA;71;TOLOSA;3;2;A;524;332;0;332;0;332;192;118;8;;;34;2;0;2;;;119;;0;0;46;3
GIPUZKOA;71;TOLOSA;3;2;B;530;335;0;335;0;335;195;110;10;;;40;1;0;2;;;118;;0;0;54;0
GIPUZKOA;71;TOLOSA;3;3;A;806;520;1;519;1;518;286;202;19;;;22;4;3;4;;;198;;0;0;65;1
GIPUZKOA;71;TOLOSA;3;3;B;763;493;0;493;5;488;270;190;25;;;17;1;0;9;;;172;;0;0;74;0
GIPUZKOA;71;TOLOSA;4;1;A;566;337;1;336;0;336;229;119;4;;;12;4;1;0;;;133;;2;0;61;0
GIPUZKOA;71;TOLOSA;4;1;B;534;318;3;315;4;311;216;98;12;;;18;2;2;2;;;134;;0;0;43;0
GIPUZKOA;71;TOLOSA;4;2;A;551;359;1;358;1;357;192;140;8;;;21;5;1;1;;;123;;1;0;55;2
GIPUZKOA;71;TOLOSA;4;2;B;608;378;1;377;1;376;230;128;7;;;25;2;1;3;;;129;;1;0;79;1
GIPUZKOA;72;URNIETA;1;1;A;468;266;1;265;2;263;202;98;13;;;44;1;2;1;;;75;;0;0;29;0
GIPUZKOA;72;URNIETA;1;1;B;485;304;1;303;1;302;181;133;17;;;43;0;0;7;;;66;;2;0;34;0
GIPUZKOA;72;URNIETA;1;2;A;519;293;2;291;2;289;226;107;17;;;27;2;0;1;;;89;;2;0;44;0
GIPUZKOA;72;URNIETA;1;2;B;538;321;1;320;4;316;217;113;15;;;42;3;4;7;;;78;;2;0;51;1
GIPUZKOA;72;URNIETA;1;3;A;780;429;1;428;4;424;351;158;11;;;41;5;1;8;;;126;;2;0;72;0
GIPUZKOA;72;URNIETA;1;3;B;793;425;1;424;2;422;368;138;37;;;68;2;1;7;;;103;;1;0;64;1
GIPUZKOA;72;URNIETA;1;4;A;563;323;2;321;3;318;240;113;19;;;42;2;2;10;;;75;;1;0;53;1
GIPUZKOA;72;URNIETA;1;4;B;600;388;0;388;2;386;212;171;20;;;28;4;3;4;;;92;;2;0;61;1
GIPUZKOA;73;USURBIL;1;1;A;857;585;2;583;3;580;272;147;9;;;18;3;2;0;;;329;;6;2;64;0
GIPUZKOA;73;USURBIL;1;1;B;807;520;0;520;1;519;287;108;15;;;31;4;0;2;;;275;;2;0;82;0
GIPUZKOA;73;USURBIL;1;2;A;495;276;0;276;2;274;219;75;11;;;17;6;0;6;;;118;;2;0;38;1
GIPUZKOA;73;USURBIL;1;2;B;364;219;0;219;0;219;145;71;3;;;3;0;0;0;;;123;;4;0;15;0
GIPUZKOA;73;USURBIL;1;3;A;601;379;0;379;1;378;222;87;11;;;21;1;2;5;;;201;;2;0;48;0
GIPUZKOA;73;USURBIL;1;3;B;588;366;3;363;4;359;222;75;9;;;33;0;0;5;;;184;;2;0;50;1
GIPUZKOA;73;USURBIL;1;3;C;377;247;2;245;1;244;130;47;11;;;16;1;2;5;;;137;;3;0;20;2
GIPUZKOA;73;USURBIL;1;4;U;597;390;0;390;0;390;207;94;10;;;17;0;1;3;;;202;;6;4;52;1
GIPUZKOA;74;BERGARA;1;1;A;631;416;2;414;3;411;215;123;10;;;30;4;2;2;;;164;;1;0;74;1
GIPUZKOA;74;BERGARA;1;1;B;678;433;0;433;2;431;245;127;11;;;32;0;2;3;;;170;;0;1;84;1
GIPUZKOA;74;BERGARA;1;2;A;806;579;2;577;2;575;227;277;14;;;22;2;1;6;;;204;;1;0;46;2
GIPUZKOA;74;BERGARA;1;2;B;745;534;0;534;4;530;211;228;53;;;36;0;0;6;;;195;;1;0;9;2
GIPUZKOA;74;BERGARA;1;3;U;627;453;2;451;0;451;174;142;12;;;28;0;0;3;;;206;;2;1;57;0
GIPUZKOA;74;BERGARA;1;4;U;753;478;2;476;2;474;275;183;21;;;28;1;1;3;;;180;;5;0;51;1
GIPUZKOA;74;BERGARA;1;5;A;674;491;2;489;0;489;183;215;14;;;24;0;0;1;;;183;;2;0;47;3
GIPUZKOA;74;BERGARA;1;5;B;746;547;2;545;4;541;199;233;16;;;24;1;0;4;;;214;;0;0;49;0
GIPUZKOA;74;BERGARA;2;1;U;724;519;1;518;2;516;205;191;29;;;45;1;0;6;;;187;;0;0;55;2
GIPUZKOA;74;BERGARA;2;2;U;635;415;0;415;1;414;220;163;24;;;44;3;0;3;;;137;;0;0;40;0
GIPUZKOA;74;BERGARA;2;3;A;774;508;1;507;1;506;266;160;10;;;26;5;2;1;;;231;;1;0;69;1
GIPUZKOA;74;BERGARA;2;3;B;687;424;1;423;2;421;263;131;8;;;40;0;0;0;;;157;;1;0;84;0
GIPUZKOA;74;BERGARA;2;3;C;406;258;0;258;3;255;148;84;5;;;14;1;0;0;;;120;;2;0;29;0
GIPUZKOA;74;BERGARA;3;1;A;542;328;2;326;0;326;214;117;8;;;21;1;1;2;;;122;;0;0;54;0
GIPUZKOA;74;BERGARA;3;1;B;589;385;0;385;2;383;204;134;11;;;42;2;0;1;;;119;;3;0;71;0
GIPUZKOA;74;BERGARA;3;2;U;769;454;3;451;3;448;315;140;19;;;52;1;1;6;;;142;;2;0;85;0
GIPUZKOA;74;BERGARA;3;3;U;794;535;4;531;3;528;259;156;3;;;14;2;0;2;;;269;;3;0;79;0
GIPUZKOA;75;VILLABONA;1;1;A;883;560;2;558;3;555;323;205;19;;;36;0;1;8;;;227;;3;0;56;0
GIPUZKOA;75;VILLABONA;1;1;B;805;496;3;493;2;491;309;181;24;;;25;2;1;9;;;190;;1;1;56;1
GIPUZKOA;75;VILLABONA;1;2;A;677;388;2;386;4;382;289;121;19;;;42;3;0;2;;;149;;0;1;45;0
GIPUZKOA;75;VILLABONA;1;2;B;625;399;0;399;2;397;226;130;19;;;41;3;1;8;;;147;;1;0;47;0
GIPUZKOA;75;VILLABONA;1;3;A;687;427;0;427;5;422;260;154;8;;;11;1;0;1;;;189;;0;0;56;2
GIPUZKOA;75;VILLABONA;1;3;B;691;428;0;428;1;427;263;166;13;;;25;2;2;3;;;162;;0;0;51;3
GIPUZKOA;76;ORDIZIA;1;1;U;775;542;2;540;1;539;233;191;23;;;31;3;1;2;;;224;;2;0;61;1
GIPUZKOA;76;ORDIZIA;1;2;U;740;451;1;450;1;449;289;171;24;;;32;1;0;1;;;167;;0;0;52;1
GIPUZKOA;76;ORDIZIA;1;3;U;966;636;3;633;4;629;330;225;47;;;57;4;2;7;;;197;;2;0;88;0
GIPUZKOA;76;ORDIZIA;1;4;U;836;591;2;589;4;585;245;243;31;;;49;3;0;2;;;184;;2;0;71;0
GIPUZKOA;76;ORDIZIA;1;5;U;1197;776;0;776;1;775;421;264;40;;;62;2;3;9;;;282;;3;1;105;4
GIPUZKOA;76;ORDIZIA;1;6;U;1240;716;1;715;2;713;524;230;37;;;109;6;2;10;;;167;;6;0;145;1
GIPUZKOA;76;ORDIZIA;1;8;U;1217;823;0;823;6;817;394;300;32;;;50;10;1;13;;;296;;0;0;112;3
GIPUZKOA;77;URRETXU;1;1;U;646;410;3;407;4;403;236;141;25;;;60;3;0;4;;;114;;2;1;52;1
GIPUZKOA;77;URRETXU;1;2;A;591;366;1;365;4;361;225;117;10;;;45;3;0;3;;;114;;3;0;63;3
GIPUZKOA;77;URRETXU;1;2;B;554;342;1;341;3;338;212;124;13;;;56;2;1;3;;;85;;3;0;50;1
GIPUZKOA;77;URRETXU;1;3;A;464;298;1;297;2;295;166;101;8;;;26;2;1;8;;;97;;2;0;49;1
GIPUZKOA;77;URRETXU;1;3;B;441;296;0;296;0;296;145;112;7;;;28;1;0;4;;;99;;1;0;42;2
GIPUZKOA;77;URRETXU;1;4;U;696;470;2;468;6;462;226;197;17;;;63;1;2;11;;;135;;2;1;33;0
GIPUZKOA;77;URRETXU;1;5;U;750;486;3;483;1;482;264;214;9;;;71;3;0;4;;;128;;8;0;45;0
GIPUZKOA;77;URRETXU;1;6;A;565;366;0;366;4;362;199;155;14;;;43;1;0;6;;;104;;1;0;38;0
GIPUZKOA;77;URRETXU;1;6;B;512;337;1;336;4;332;175;124;16;;;50;0;1;6;;;72;;5;0;58;0
GIPUZKOA;78;ZALDIBIA;1;1;A;543;406;0;406;1;405;137;69;5;;;5;2;0;2;;;292;;0;0;30;0
GIPUZKOA;78;ZALDIBIA;1;1;B;618;468;0;468;7;461;150;110;2;;;13;2;0;3;;;295;;1;0;34;1
GIPUZKOA;79;ZARAUTZ;1;1;A;788;524;1;523;3;520;264;209;25;;;34;1;1;4;;;190;;1;0;55;0
GIPUZKOA;79;ZARAUTZ;1;1;B;759;501;1;500;1;499;258;199;14;;;42;2;1;4;;;178;;0;0;58;1
GIPUZKOA;79;ZARAUTZ;1;2;A;509;321;2;319;2;317;188;133;20;;;15;2;0;3;;;109;;1;0;34;0
GIPUZKOA;79;ZARAUTZ;1;2;B;469;301;1;300;3;297;168;134;11;;;16;0;1;4;;;102;;0;0;29;0
GIPUZKOA;79;ZARAUTZ;1;3;A;474;301;0;301;1;300;173;127;26;;;17;1;0;2;;;100;;0;0;27;0
GIPUZKOA;79;ZARAUTZ;1;3;B;503;337;1;336;1;335;166;166;14;;;18;0;0;2;;;97;;0;0;38;0
GIPUZKOA;79;ZARAUTZ;2;1;A;623;427;0;427;2;425;196;228;41;;;27;0;0;5;;;77;;0;0;47;0
GIPUZKOA;79;ZARAUTZ;2;1;B;619;445;2;443;3;440;174;254;47;;;17;4;0;7;;;77;;1;0;33;0
GIPUZKOA;79;ZARAUTZ;2;2;A;722;535;0;535;5;530;187;275;50;;;27;8;1;2;;;115;;2;0;50;0
GIPUZKOA;79;ZARAUTZ;2;2;B;694;509;0;509;3;506;185;259;52;;;31;1;1;3;;;116;;0;1;40;2
GIPUZKOA;79;ZARAUTZ;2;3;A;745;505;2;503;2;501;240;183;21;;;42;5;0;4;;;172;;0;1;73;0
GIPUZKOA;79;ZARAUTZ;2;3;B;810;506;0;506;1;505;304;175;17;;;46;3;4;3;;;185;;4;0;68;0
GIPUZKOA;79;ZARAUTZ;2;4;A;699;422;1;421;2;419;277;149;21;;;44;1;1;6;;;133;;4;0;59;1
GIPUZKOA;79;ZARAUTZ;2;4;B;680;399;0;399;3;396;281;111;41;;;61;5;1;7;;;121;;0;0;49;0
GIPUZKOA;79;ZARAUTZ;2;5;A;587;379;1;378;3;375;208;136;12;;;42;1;1;6;;;136;;0;0;41;0
GIPUZKOA;79;ZARAUTZ;2;5;B;637;427;0;427;1;426;210;148;20;;;46;1;0;4;;;135;;4;0;68;0
GIPUZKOA;79;ZARAUTZ;2;6;A;683;437;0;437;1;436;246;133;15;;;33;4;0;1;;;180;;1;0;69;0
GIPUZKOA;79;ZARAUTZ;2;6;B;730;438;0;438;1;437;292;162;17;;;27;4;1;4;;;138;;1;0;82;1
GIPUZKOA;79;ZARAUTZ;2;7;A;506;307;0;307;2;305;199;111;17;;;18;2;0;5;;;84;;3;0;65;0
GIPUZKOA;79;ZARAUTZ;2;7;B;447;260;3;257;1;256;187;73;12;;;23;0;0;1;;;98;;3;0;44;2
GIPUZKOA;79;ZARAUTZ;2;7;C;328;201;1;200;4;196;127;93;5;;;3;0;0;0;;;78;;0;0;17;0
GIPUZKOA;79;ZARAUTZ;2;8;A;777;530;3;527;7;520;247;271;26;;;38;3;0;8;;;112;;0;0;60;2
GIPUZKOA;79;ZARAUTZ;2;8;B;753;512;3;509;5;504;241;229;30;;;25;1;1;5;;;133;;1;0;78;1
GIPUZKOA;79;ZARAUTZ;2;9;A;732;448;0;448;4;444;284;177;12;;;41;1;1;2;;;140;;0;0;69;1
GIPUZKOA;79;ZARAUTZ;2;9;B;620;396;0;396;5;391;224;161;14;;;33;3;1;9;;;92;;4;1;72;1
GIPUZKOA;79;ZARAUTZ;2;10;A;532;388;1;387;4;383;144;159;14;;;20;1;1;4;;;140;;0;0;44;0
GIPUZKOA;79;ZARAUTZ;2;10;B;533;357;2;355;1;354;176;157;19;;;17;3;1;4;;;106;;1;0;46;0
GIPUZKOA;79;ZARAUTZ;2;11;U;905;619;2;617;4;613;286;276;19;;;68;0;0;7;;;176;;1;0;64;2
GIPUZKOA;80;ZUMARRAGA;1;1;U;880;601;2;599;3;596;279;267;30;;;62;5;0;7;;;148;;4;0;71;2
GIPUZKOA;80;ZUMARRAGA;1;2;A;649;408;1;407;2;405;241;129;21;;;107;4;1;7;;;78;;2;0;56;0
GIPUZKOA;80;ZUMARRAGA;1;2;B;667;403;0;403;4;399;264;137;29;;;84;0;0;9;;;85;;3;0;51;1
GIPUZKOA;80;ZUMARRAGA;1;3;U;634;396;5;391;7;384;238;126;23;;;76;0;1;9;;;84;;0;0;63;2
GIPUZKOA;80;ZUMARRAGA;1;4;U;603;373;1;372;5;367;230;106;16;;;87;2;0;6;;;82;;3;0;64;1
GIPUZKOA;80;ZUMARRAGA;1;5;A;602;342;2;340;1;339;260;72;29;;;93;5;0;11;;;50;;2;0;74;3
GIPUZKOA;80;ZUMARRAGA;1;5;B;719;403;2;401;3;398;316;81;33;;;118;2;1;6;;;59;;11;0;87;0
GIPUZKOA;80;ZUMARRAGA;1;5;C;620;351;0;351;2;349;269;75;31;;;104;2;1;6;;;47;;0;0;83;0
GIPUZKOA;80;ZUMARRAGA;1;6;A;620;396;1;395;2;393;224;107;21;;;96;7;0;2;;;86;;4;0;69;1
GIPUZKOA;80;ZUMARRAGA;1;6;B;609;369;3;366;2;364;240;95;23;;;104;2;1;1;;;68;;0;1;69;0
GIPUZKOA;80;ZUMARRAGA;1;7;U;512;296;1;295;1;294;216;114;6;;;40;2;1;0;;;101;;0;0;30;0
GIPUZKOA;80;ZUMARRAGA;1;8;U;781;456;3;453;0;453;325;159;24;;;82;1;0;6;;;102;;4;0;75;0
GIPUZKOA;81;ZUMAIA;1;1;A;901;612;3;609;3;606;289;233;12;;;24;1;0;6;;;244;;2;0;83;1
GIPUZKOA;81;ZUMAIA;1;1;B;947;646;1;645;1;644;301;253;10;;;35;7;1;6;;;250;;5;0;76;1
GIPUZKOA;81;ZUMAIA;1;2;A;627;401;1;400;2;398;226;146;10;;;54;0;0;2;;;136;;5;0;45;0
GIPUZKOA;81;ZUMAIA;1;2;B;637;375;2;373;3;370;262;157;7;;;53;4;0;4;;;109;;2;0;34;0
GIPUZKOA;81;ZUMAIA;1;3;A;827;514;2;512;6;506;313;171;5;;;55;1;0;4;;;188;;3;0;79;0
GIPUZKOA;81;ZUMAIA;1;3;B;866;555;4;551;1;550;311;217;12;;;53;3;3;8;;;192;;0;0;61;1
GIPUZKOA;81;ZUMAIA;1;4;A;479;303;0;303;0;303;176;103;12;;;24;2;0;2;;;115;;1;0;44;0
GIPUZKOA;81;ZUMAIA;1;4;B;509;298;0;298;4;294;211;97;10;;;27;1;1;2;;;120;;1;0;34;1
GIPUZKOA;81;ZUMAIA;1;5;U;818;514;1;513;4;509;304;214;19;;;36;2;0;5;;;154;;9;0;68;2
GIPUZKOA;81;ZUMAIA;1;6;U;886;502;0;502;9;493;384;187;7;;;56;4;1;0;;;166;;1;0;68;3
GIPUZKOA;901;MENDARO;1;1;A;711;437;3;434;1;433;274;190;17;;;26;1;0;5;;;123;;5;0;65;1
GIPUZKOA;901;MENDARO;1;1;B;729;467;2;465;3;462;262;183;17;;;31;1;0;5;;;145;;1;0;79;0
GIPUZKOA;902;LASARTE-ORIA;1;1;A;569;383;2;381;2;379;186;103;8;;;41;0;1;5;;;168;;4;0;47;2
GIPUZKOA;902;LASARTE-ORIA;1;1;B;584;387;2;385;1;384;197;100;24;;;43;2;0;2;;;147;;3;0;63;0
GIPUZKOA;902;LASARTE-ORIA;1;2;A;555;315;1;314;2;312;240;64;33;;;92;2;0;9;;;55;;4;0;52;1
GIPUZKOA;902;LASARTE-ORIA;1;2;B;586;341;2;339;1;338;245;71;30;;;97;4;0;9;;;51;;3;1;71;1
GIPUZKOA;902;LASARTE-ORIA;1;3;A;623;386;1;385;0;385;237;95;32;;;136;2;0;12;;;53;;2;0;53;0
GIPUZKOA;902;LASARTE-ORIA;1;3;B;597;365;4;361;1;360;232;65;34;;;147;1;2;9;;;45;;1;0;54;2
GIPUZKOA;902;LASARTE-ORIA;1;4;A;517;315;0;315;2;313;202;84;21;;;63;3;0;1;;;91;;2;0;48;0
GIPUZKOA;902;LASARTE-ORIA;1;4;B;520;295;0;295;0;295;225;65;30;;;63;1;1;4;;;83;;6;0;42;0
GIPUZKOA;902;LASARTE-ORIA;1;5;U;566;345;2;343;1;342;221;93;52;;;73;2;0;13;;;75;;1;0;33;0
GIPUZKOA;902;LASARTE-ORIA;1;6;A;574;341;3;338;3;335;233;94;19;;;50;2;0;7;;;106;;6;0;51;0
GIPUZKOA;902;LASARTE-ORIA;1;6;B;627;356;0;356;1;355;271;106;13;;;69;4;0;5;;;96;;3;0;58;1
GIPUZKOA;902;LASARTE-ORIA;1;7;A;439;271;0;271;3;268;168;47;34;;;93;2;0;11;;;32;;5;0;41;3
GIPUZKOA;902;LASARTE-ORIA;1;7;B;470;301;4;297;1;296;169;45;40;;;127;1;0;9;;;27;;2;0;44;1
GIPUZKOA;902;LASARTE-ORIA;1;8;U;898;529;1;528;1;527;369;115;79;;;170;6;1;18;;;67;;2;0;68;1
GIPUZKOA;902;LASARTE-ORIA;1;9;A;629;387;1;386;2;384;242;105;20;;;58;0;1;12;;;123;;4;0;60;1
GIPUZKOA;902;LASARTE-ORIA;1;9;B;614;385;0;385;1;384;229;100;28;;;93;3;0;10;;;84;;3;1;60;2
GIPUZKOA;902;LASARTE-ORIA;1;9;C;630;379;2;377;2;375;251;93;16;;;77;4;0;10;;;112;;3;0;57;3
GIPUZKOA;902;LASARTE-ORIA;1;10;U;701;379;6;373;2;371;322;98;25;;;97;4;2;11;;;57;;2;0;73;2
GIPUZKOA;902;LASARTE-ORIA;1;11;A;752;443;1;442;2;440;309;107;36;;;95;3;0;15;;;96;;5;0;81;2
GIPUZKOA;902;LASARTE-ORIA;1;11;B;741;441;0;441;2;439;300;109;30;;;97;6;1;17;;;81;;2;0;96;0
GIPUZKOA;902;LASARTE-ORIA;1;12;U;846;475;0;475;2;473;371;99;37;;;121;9;0;12;;;111;;3;0;77;4
GIPUZKOA;902;LASARTE-ORIA;1;13;A;554;351;0;351;8;343;203;83;31;;;83;2;0;8;;;61;;4;0;68;3
GIPUZKOA;902;LASARTE-ORIA;1;13;B;549;344;0;344;2;342;205;82;27;;;96;2;3;9;;;61;;2;0;59;1
GIPUZKOA;903;ASTIGARRAGA;1;1;A;691;417;3;414;1;413;274;135;10;;;30;6;0;3;;;155;;1;0;71;2
GIPUZKOA;903;ASTIGARRAGA;1;1;B;728;404;0;404;1;403;324;112;17;;;21;6;1;6;;;143;;1;0;93;3
GIPUZKOA;903;ASTIGARRAGA;1;2;A;582;368;1;367;2;365;214;162;13;;;14;4;0;3;;;139;;1;0;29;0
GIPUZKOA;903;ASTIGARRAGA;1;2;B;612;352;0;352;3;349;260;137;11;;;17;0;1;4;;;120;;2;0;57;0
GIPUZKOA;903;ASTIGARRAGA;1;3;A;886;538;1;537;2;535;348;156;24;;;33;2;0;9;;;205;;1;0;101;4
GIPUZKOA;903;ASTIGARRAGA;1;3;B;844;480;3;477;5;472;364;134;19;;;32;2;1;7;;;188;;1;0;86;2
GIPUZKOA;904;BALIARRAIN;1;1;U;92;51;0;51;0;51;41;10;0;;;0;1;0;0;;;39;;0;0;1;0
GIPUZKOA;905;ORENDAIN;1;1;U;145;107;1;106;1;105;38;36;0;;;1;0;0;0;;;63;;0;0;5;0
GIPUZKOA;906;ALTZAGA;1;1;U;116;80;0;80;0;80;36;27;0;;;1;1;0;0;;;43;;0;0;8;0
GIPUZKOA;907;GAZTELU;1;1;U;121;93;0;93;0;93;28;35;1;;;1;0;0;0;;;44;;0;0;12;0
GIPUZKOA;999;MUNICIPIO CERA GIPUZKOA;1;1;U;25945;1437;1;1436;2;1434;24508;323;144;;;135;12;6;34;;;482;;2;4;285;7
ARABA/ÁLAVA;1;ALEGRÍA-DULANTZI;1;1;A;475;275;2;273;5;268;200;115;26;;;25;3;;4;0;0;55;0;1;;37;2
ARABA/ÁLAVA;1;ALEGRÍA-DULANTZI;1;1;B;492;294;3;291;1;290;198;103;22;;;33;2;;7;1;0;76;0;3;;43;0
ARABA/ÁLAVA;1;ALEGRÍA-DULANTZI;1;2;A;516;312;1;311;1;310;204;94;33;;;42;4;;13;1;0;63;0;2;;56;2
ARABA/ÁLAVA;1;ALEGRÍA-DULANTZI;1;2;B;503;296;2;294;2;292;207;91;39;;;43;6;;5;0;0;47;1;0;;59;1
ARABA/ÁLAVA;2;AMURRIO;1;1;A;625;452;4;448;1;447;173;195;26;;;30;3;;7;0;0;114;12;1;;58;1
ARABA/ÁLAVA;2;AMURRIO;1;1;B;606;409;4;405;2;403;197;165;41;;;25;0;;1;0;0;90;4;2;;73;2
ARABA/ÁLAVA;2;AMURRIO;1;1;C;289;190;0;190;4;186;99;106;10;;;5;0;;2;0;0;38;0;1;;23;1
ARABA/ÁLAVA;2;AMURRIO;1;2;A;602;397;4;393;5;388;205;164;23;;;26;3;;13;3;0;100;0;0;;56;0
ARABA/ÁLAVA;2;AMURRIO;1;2;B;537;362;3;359;2;357;175;161;27;;;19;2;;10;1;0;90;0;2;;43;2
ARABA/ÁLAVA;2;AMURRIO;1;2;C;232;166;0;166;1;165;66;93;5;;;0;0;;0;0;0;44;0;0;;23;0
ARABA/ÁLAVA;2;AMURRIO;1;3;A;531;364;2;362;1;361;167;141;23;;;24;2;;2;1;0;105;2;3;;58;0
ARABA/ÁLAVA;2;AMURRIO;1;3;B;551;401;6;395;5;390;150;170;29;;;18;2;;5;0;0;104;4;0;;56;2
ARABA/ÁLAVA;2;AMURRIO;1;4;A;651;468;1;467;4;463;183;189;28;;;39;6;;5;2;0;115;0;2;;76;1
ARABA/ÁLAVA;2;AMURRIO;1;4;B;722;503;4;499;3;496;219;186;34;;;37;2;;1;1;0;148;2;4;;79;2
ARABA/ÁLAVA;2;AMURRIO;1;5;A;507;344;8;336;1;335;163;141;30;;;38;1;;6;0;0;66;2;2;;46;3
ARABA/ÁLAVA;2;AMURRIO;1;5;B;484;318;1;317;2;315;166;127;26;;;43;0;;4;1;1;63;1;1;;47;1
ARABA/ÁLAVA;2;AMURRIO;1;6;A;509;360;4;356;1;355;149;143;18;;;30;5;;1;1;1;85;3;0;;67;1
ARABA/ÁLAVA;2;AMURRIO;1;6;B;538;356;2;354;1;353;182;127;14;;;28;3;;1;2;0;92;3;2;;79;2
ARABA/ÁLAVA;2;AMURRIO;1;7;U;736;484;1;483;0;483;252;190;22;;;59;2;;8;3;0;113;2;2;;81;1
ARABA/ÁLAVA;3;ARAMAIO;1;1;A;573;404;2;402;2;400;169;153;4;;;5;0;;0;0;0;210;0;1;;27;0
ARABA/ÁLAVA;3;ARAMAIO;1;1;B;618;435;0;435;2;433;183;136;1;;;11;1;;0;1;0;224;4;5;;50;0
ARABA/ÁLAVA;4;ARTZINIEGA;1;1;A;662;440;6;434;4;430;222;185;57;;;30;4;;5;1;1;87;2;3;;54;1
ARABA/ÁLAVA;4;ARTZINIEGA;1;1;B;746;507;5;502;2;500;239;204;42;;;27;5;;6;0;0;147;2;3;;63;1
ARABA/ÁLAVA;6;ARMIÑÓN;1;1;U;174;110;3;107;0;107;64;18;30;;;12;2;;5;0;0;12;3;2;;22;1
ARABA/ÁLAVA;8;ARRATZUA-UBARRUNDIA;1;1;U;778;480;3;477;3;474;298;172;82;;;33;3;;10;0;0;114;3;0;;51;6
ARABA/ÁLAVA;9;ASPARRENA;1;1;A;577;366;2;364;2;362;211;123;22;;;17;1;;2;1;0;143;0;1;;52;0
ARABA/ÁLAVA;9;ASPARRENA;1;1;B;691;437;1;436;3;433;254;174;20;;;28;3;;1;1;0;148;0;0;;55;3
ARABA/ÁLAVA;10;AYALA/AIARA;1;1;A;461;332;2;330;0;330;129;164;28;;;12;2;;1;0;0;81;1;1;;39;1
ARABA/ÁLAVA;10;AYALA/AIARA;1;1;B;493;332;4;328;0;328;161;173;24;;;10;2;;4;0;1;85;0;2;;27;0
ARABA/ÁLAVA;10;AYALA/AIARA;1;1;C;440;339;2;337;1;336;101;167;19;;;7;1;;0;1;1;92;6;2;;39;1
ARABA/ÁLAVA;10;AYALA/AIARA;1;2;U;877;590;6;584;3;581;287;245;33;;;36;4;;12;2;1;147;0;3;;97;1
ARABA/ÁLAVA;11;BAÑOS DE EBRO/MAÑUETA;1;1;U;230;148;4;144;2;142;82;55;56;;;15;0;;4;0;0;4;0;3;;5;0
ARABA/ÁLAVA;13;BARRUNDIA;1;1;U;715;437;0;437;0;437;278;138;42;;;21;1;;3;0;0;166;3;0;;61;2
ARABA/ÁLAVA;14;BERANTEVILLA;1;1;U;371;238;1;237;2;235;133;87;67;;;17;4;;3;1;0;26;2;0;;28;0
ARABA/ÁLAVA;16;BERNEDO;1;1;U;432;209;2;207;2;205;223;77;43;;;9;0;;0;0;1;49;0;1;;23;2
ARABA/ÁLAVA;17;CAMPEZO/KANPEZU;1;1;U;841;511;2;509;2;507;330;217;57;;;26;3;;6;1;0;140;5;3;;48;1
ARABA/ÁLAVA;18;ZIGOITIA;1;1;A;670;431;0;431;2;429;239;121;44;;;32;0;;5;0;0;148;1;4;;71;3
ARABA/ÁLAVA;18;ZIGOITIA;1;1;B;711;463;0;463;2;461;248;141;53;;;33;2;;10;0;0;136;2;2;;82;0
ARABA/ÁLAVA;19;KRIPAN;1;1;U;151;113;0;113;1;112;38;76;13;;;2;1;;0;0;0;13;0;0;;7;0
ARABA/ÁLAVA;20;KUARTANGO;1;1;U;326;222;2;220;2;218;104;92;20;;;5;1;;3;1;0;69;0;2;;25;0
ARABA/ÁLAVA;21;ELBURGO/BURGELU;1;1;U;469;288;0;288;1;287;181;138;54;;;14;5;;9;0;0;31;2;3;;29;2
ARABA/ÁLAVA;22;ELCIEGO;1;1;U;799;509;11;498;5;493;290;132;128;;;92;6;;18;0;0;44;5;3;;63;2
ARABA/ÁLAVA;23;ELVILLAR/BILAR;1;1;U;267;167;0;167;1;166;100;63;42;;;14;1;;1;1;0;27;0;1;;16;0
ARABA/ÁLAVA;27;IRURAIZ-GAUNA;1;1;U;421;243;0;243;1;242;178;100;27;;;9;4;;2;0;0;66;1;1;;32;0
ARABA/ÁLAVA;28;LABASTIDA/BASTIDA;1;1;A;523;294;1;293;1;292;229;80;85;;;24;3;;6;0;0;42;4;0;;46;2
ARABA/ÁLAVA;28;LABASTIDA/BASTIDA;1;1;B;549;325;3;322;1;321;224;85;73;;;41;4;;14;0;1;43;8;1;;51;0
ARABA/ÁLAVA;30;LAGRÁN;1;1;U;156;103;0;103;0;103;53;42;27;;;10;0;;1;0;0;8;0;0;;14;1
ARABA/ÁLAVA;31;LAGUARDIA;1;1;A;553;383;6;377;2;375;170;113;113;;;18;3;;16;1;0;67;2;2;;39;1
ARABA/ÁLAVA;31;LAGUARDIA;1;1;B;608;418;5;413;3;410;190;112;128;;;35;1;;18;0;0;64;1;3;;48;0
ARABA/ÁLAVA;32;LANCIEGO/LANTZIEGO;1;1;U;512;328;5;323;0;323;184;127;64;;;43;1;;13;0;0;38;1;1;;34;1
ARABA/ÁLAVA;33;LAPUEBLA DE LABARCA;1;1;U;644;462;5;457;4;453;182;216;84;;;47;1;;13;1;0;51;0;3;;36;1
ARABA/ÁLAVA;34;LEZA;1;1;U;156;107;0;107;0;107;49;50;5;;;17;0;;0;1;0;27;0;0;;7;0
ARABA/ÁLAVA;36;LAUDIO/LLODIO;1;1;A;614;417;7;410;4;406;197;199;47;;;34;1;;8;1;0;71;3;3;;37;2
ARABA/ÁLAVA;36;LAUDIO/LLODIO;1;1;B;701;427;4;423;1;422;274;163;57;;;42;3;;15;1;0;90;0;2;;48;1
ARABA/ÁLAVA;36;LAUDIO/LLODIO;1;2;A;759;487;1;486;1;485;272;192;31;;;46;3;;7;2;0;116;7;3;;74;4
ARABA/ÁLAVA;36;LAUDIO/LLODIO;1;2;B;729;481;0;481;7;474;248;185;44;;;52;2;;3;1;0;107;2;2;;75;1
ARABA/ÁLAVA;36;LAUDIO/LLODIO;1;3;A;672;405;1;404;7;397;267;125;25;;;56;3;;5;0;0;112;2;2;;66;1
ARABA/ÁLAVA;36;LAUDIO/LLODIO;1;3;B;702;420;1;419;3;416;282;143;26;;;61;6;;5;0;0;114;0;2;;57;2
ARABA/ÁLAVA;36;LAUDIO/LLODIO;1;4;A;480;305;0;305;2;303;175;106;23;;;39;3;;8;1;0;72;0;5;;46;0
ARABA/ÁLAVA;36;LAUDIO/LLODIO;1;4;B;530;321;3;318;1;317;209;120;25;;;30;5;;5;1;0;71;2;2;;56;0
ARABA/ÁLAVA;36;LAUDIO/LLODIO;1;5;A;706;419;3;416;3;413;287;121;31;;;52;1;;4;0;3;124;2;1;;74;0
ARABA/ÁLAVA;36;LAUDIO/LLODIO;1;5;B;856;525;3;522;2;520;331;169;29;;;46;2;;5;0;1;160;2;1;;102;3
ARABA/ÁLAVA;36;LAUDIO/LLODIO;1;6;A;878;589;3;586;1;585;289;236;66;;;58;4;;11;1;2;132;0;2;;70;3
ARABA/ÁLAVA;36;LAUDIO/LLODIO;1;6;B;845;585;5;580;6;574;260;249;52;;;56;4;;10;2;1;114;2;2;;78;4
ARABA/ÁLAVA;36;LAUDIO/LLODIO;1;7;A;491;327;1;326;2;324;164;110;46;;;46;3;;4;4;0;54;1;4;;51;1
ARABA/ÁLAVA;36;LAUDIO/LLODIO;1;7;B;511;332;2;330;0;330;179;109;31;;;48;4;;3;0;0;74;2;4;;48;7
ARABA/ÁLAVA;36;LAUDIO/LLODIO;1;8;A;474;273;2;271;1;270;201;76;24;;;45;5;;6;1;0;60;1;2;;48;2
ARABA/ÁLAVA;36;LAUDIO/LLODIO;1;8;B;546;331;2;329;1;328;215;101;31;;;48;4;;3;1;1;71;3;2;;61;2
ARABA/ÁLAVA;36;LAUDIO/LLODIO;1;9;A;527;353;6;347;5;342;174;132;25;;;28;2;;6;0;0;106;2;2;;38;1
ARABA/ÁLAVA;36;LAUDIO/LLODIO;1;9;B;485;311;2;309;4;305;174;117;27;;;25;1;;6;0;0;87;0;0;;41;1
ARABA/ÁLAVA;36;LAUDIO/LLODIO;1;10;A;630;374;3;371;3;368;256;143;32;;;35;2;;3;0;0;102;1;3;;46;1
ARABA/ÁLAVA;36;LAUDIO/LLODIO;1;10;B;673;433;1;432;5;427;240;160;33;;;61;4;;8;0;0;86;0;3;;71;1
ARABA/ÁLAVA;36;LAUDIO/LLODIO;1;11;U;611;401;1;400;3;397;210;158;22;;;25;1;;1;0;0;137;0;1;;51;1
ARABA/ÁLAVA;36;LAUDIO/LLODIO;1;12;U;566;346;0;346;3;343;220;102;47;;;57;0;;7;0;1;68;3;1;;55;2
ARABA/ÁLAVA;36;LAUDIO/LLODIO;1;13;A;471;304;4;300;4;296;167;115;16;;;28;2;;4;0;0;74;0;0;;57;0
ARABA/ÁLAVA;36;LAUDIO/LLODIO;1;13;B;489;300;4;296;1;295;189;111;29;;;29;2;;2;0;0;53;1;0;;66;2
ARABA/ÁLAVA;37;ARRAIA-MAEZTU;1;1;U;587;397;2;395;2;393;190;179;50;;;15;1;;2;1;0;93;1;1;;50;0
ARABA/ÁLAVA;39;MOREDA DE ÁLAVA/MOREDA ARABA;1;1;U;210;157;7;150;0;150;53;49;28;;;31;1;;1;0;0;19;0;1;;20;0
ARABA/ÁLAVA;41;NAVARIDAS;1;1;U;149;104;0;104;1;103;45;42;39;;;4;1;;0;1;0;6;0;0;;8;2
ARABA/ÁLAVA;42;OKONDO;1;1;A;412;303;3;300;5;295;109;143;20;;;9;2;;0;1;0;86;1;0;;33;0
ARABA/ÁLAVA;42;OKONDO;1;1;B;483;336;1;335;5;330;147;156;17;;;7;3;;2;0;0;103;0;0;;41;1
ARABA/ÁLAVA;43;OYÓN-OION;1;1;U;806;452;3;449;2;447;354;123;111;;;60;1;;13;2;0;82;2;3;;49;1
ARABA/ÁLAVA;43;OYÓN-OION;1;2;A;756;418;1;417;6;411;338;116;74;;;55;6;;14;1;0;72;3;3;;64;3
ARABA/ÁLAVA;43;OYÓN-OION;1;2;B;754;419;4;415;5;410;335;114;77;;;60;4;;24;0;0;71;5;0;;55;0
ARABA/ÁLAVA;44;PEÑACERRADA-URIZAHARRA;1;1;U;233;165;0;165;2;163;68;61;34;;;10;1;;4;0;0;30;1;2;;20;0
ARABA/ÁLAVA;46;ERRIBERAGOITIA/RIBERA ALTA;1;1;U;594;397;2;395;4;391;197;145;71;;;37;4;;15;0;0;59;0;2;;58;0
ARABA/ÁLAVA;47;RIBERA BAJA/ERRIBERA BEITIA;1;1;A;452;287;4;283;2;281;165;103;60;;;41;5;;13;0;0;13;3;1;;42;0
ARABA/ÁLAVA;47;RIBERA BAJA/ERRIBERA BEITIA;1;1;B;513;302;3;299;2;297;211;92;69;;;28;4;;17;0;0;26;5;1;;54;1
ARABA/ÁLAVA;49;AÑANA;1;1;U;140;102;0;102;1;101;38;39;14;;;7;1;;0;1;0;30;1;1;;7;0
ARABA/ÁLAVA;51;AGURAIN/SALVATIERRA;1;1;A;567;342;0;342;1;341;225;142;15;;;22;2;;5;1;0;108;0;0;;46;0
ARABA/ÁLAVA;51;AGURAIN/SALVATIERRA;1;1;B;577;321;0;321;1;320;256;116;18;;;29;2;;6;0;0;112;1;2;;34;0
ARABA/ÁLAVA;51;AGURAIN/SALVATIERRA;1;2;A;664;401;2;399;5;394;263;152;22;;;25;2;;5;0;0;148;3;0;;37;0
ARABA/ÁLAVA;51;AGURAIN/SALVATIERRA;1;2;B;768;466;1;465;2;463;302;174;26;;;19;2;;7;0;0;179;2;2;;52;0
ARABA/ÁLAVA;51;AGURAIN/SALVATIERRA;1;3;A;443;235;4;231;0;231;208;76;15;;;23;5;;6;0;0;65;2;1;;38;0
ARABA/ÁLAVA;51;AGURAIN/SALVATIERRA;1;3;B;574;308;1;307;1;306;266;120;23;;;32;1;;5;4;0;74;8;0;;38;1
ARABA/ÁLAVA;52;SAMANIEGO;1;1;U;254;183;0;183;0;183;71;72;11;;;40;1;;3;0;0;43;0;0;;13;0
ARABA/ÁLAVA;53;SAN MILLÁN/DONEMILIAGA;1;1;U;586;332;5;327;0;327;254;133;27;;;4;3;;5;0;1;101;1;2;;49;1
ARABA/ÁLAVA;54;URKABUSTAIZ;1;1;A;435;287;0;287;0;287;148;99;16;;;10;4;;3;0;2;111;0;0;;42;0
ARABA/ÁLAVA;54;URKABUSTAIZ;1;1;B;533;363;1;362;6;356;170;104;22;;;14;2;;2;0;0;154;0;0;;58;0
ARABA/ÁLAVA;55;VALDEGOVÍA/GAUBEA;1;1;A;344;208;4;204;1;203;136;78;48;;;14;2;;1;0;0;37;0;1;;22;0
ARABA/ÁLAVA;55;VALDEGOVÍA/GAUBEA;1;1;B;492;298;5;293;4;289;194;115;64;;;28;3;;5;1;1;37;3;1;;29;2
ARABA/ÁLAVA;56;HARANA/VALLE DE ARANA;1;1;U;218;130;0;130;1;129;88;76;17;;;3;1;;1;0;0;24;0;1;;6;0
ARABA/ÁLAVA;57;VILLABUENA DE ÁLAVA/ESKUERNAGA;1;1;U;238;203;0;203;1;202;35;85;22;;;4;1;;5;0;0;63;3;0;;19;0
ARABA/ÁLAVA;58;LEGUTIO;1;1;A;658;390;3;387;2;385;268;157;18;;;16;1;;3;1;0;138;0;0;;51;0
ARABA/ÁLAVA;58;LEGUTIO;1;1;B;698;403;2;401;4;397;295;102;15;;;31;2;;9;0;1;176;3;1;;56;1
ARABA/ÁLAVA;59;VITORIA-GASTEIZ;1;1;A;475;270;3;267;1;266;205;51;52;;;31;5;;7;1;1;67;1;1;;48;1
ARABA/ÁLAVA;59;VITORIA-GASTEIZ;1;1;B;441;261;2;259;1;258;180;61;45;;;19;5;;6;1;2;70;1;2;;44;2
ARABA/ÁLAVA;59;VITORIA-GASTEIZ;1;3;U;679;356;3;353;2;351;323;57;31;;;41;3;;8;2;0;118;1;3;;85;2
ARABA/ÁLAVA;59;VITORIA-GASTEIZ;1;4;U;880;452;6;446;2;444;428;87;46;;;45;4;;8;1;0;157;0;2;;90;4
ARABA/ÁLAVA;59;VITORIA-GASTEIZ;1;5;U;589;333;1;332;2;330;256;69;32;;;26;4;;4;0;1;124;1;2;;65;2
ARABA/ÁLAVA;59;VITORIA-GASTEIZ;1;7;U;539;325;5;320;1;319;214;61;56;;;30;4;;5;0;0;89;0;3;;67;4
ARABA/ÁLAVA;59;VITORIA-GASTEIZ;1;8;A;466;266;1;265;3;262;200;61;50;;;23;1;;6;1;1;61;3;1;;52;2
ARABA/ÁLAVA;59;VITORIA-GASTEIZ;1;8;B;463;263;6;257;5;252;200;72;46;;;27;2;;1;0;0;59;0;0;;45;0
ARABA/ÁLAVA;59;VITORIA-GASTEIZ;1;9;U;539;259;2;257;0;257;280;72;36;;;23;4;;7;0;4;70;0;0;;41;0
ARABA/ÁLAVA;59;VITORIA-GASTEIZ;1;10;A;487;276;0;276;1;275;211;53;41;;;18;2;;5;2;0;79;2;4;;68;1
ARABA/ÁLAVA;59;VITORIA-GASTEIZ;1;10;B;551;318;2;316;2;314;233;52;54;;;31;5;;7;1;0;99;0;1;;61;3
ARABA/ÁLAVA;59;VITORIA-GASTEIZ;1;12;U;857;569;1;568;6;562;288;158;169;;;43;5;;28;0;0;94;8;1;;55;1
ARABA/ÁLAVA;59;VITORIA-GASTEIZ;1;13;U;748;523;2;521;5;516;225;170;202;;;32;4;;15;0;0;49;7;0;;37;0
ARABA/ÁLAVA;59;VITORIA-GASTEIZ;1;14;U;917;578;3;575;8;567;339;177;197;;;43;5;;32;3;0;62;4;0;;39;5
ARABA/ÁLAVA;59;VITORIA-GASTEIZ;1;15;U;794;481;2;479;6;473;313;129;172;;;33;3;;25;0;0;50;3;4;;53;1
ARABA/ÁLAVA;59;VITORIA-GASTEIZ;1;16;U;628;393;1;392;5;387;235;114;145;;;37;2;;13;1;2;30;0;0;;40;3
ARABA/ÁLAVA;59;VITORIA-GASTEIZ;1;17;A;699;462;5;457;1;456;237;142;179;;;31;2;;23;1;0;39;5;0;;34;0
ARABA/ÁLAVA;59;VITORIA-GASTEIZ;1;17;B;721;494;1;493;5;488;227;135;209;;;32;3;;17;1;0;43;3;1;;41;3
ARABA/ÁLAVA;59;VITORIA-GASTEIZ;1;18;A;640;427;0;427;3;424;213;128;144;;;35;2;;24;1;0;49;2;3;;36;0
ARABA/ÁLAVA;59;VITORIA-GASTEIZ;1;18;B;605;395;3;392;2;390;210;116;126;;;33;2;;23;0;0;52;4;1;;32;1
ARABA/ÁLAVA;59;VITORIA-GASTEIZ;1;19;U;687;423;4;419;3;416;264;107;100;;;45;4;;20;3;0;71;2;2;;59;3
ARABA/ÁLAVA;59;VITORIA-GASTEIZ;1;20;U;835;473;0;473;3;470;362;131;86;;;79;6;;13;5;0;78;7;8;;55;2
ARABA/ÁLAVA;59;VITORIA-GASTEIZ;1;21;U;895;542;3;539;6;533;353;151;152;;;57;5;;12;0;0;73;4;0;;76;3
ARABA/ÁLAVA;59;VITORIA-GASTEIZ;1;22;U;681;441;2;439;6;433;240;122;170;;;50;1;;20;0;0;38;4;1;;24;3
ARABA/ÁLAVA;59;VITORIA-GASTEIZ;1;23;U;679;413;5;408;3;405;266;75;81;;;51;1;;13;0;0;94;1;4;;84;1
ARABA/ÁLAVA;59;VITORIA-GASTEIZ;1;24;U;611;312;2;310;5;305;299;73;58;;;41;5;;10;1;0;73;1;0;;39;4
ARABA/ÁLAVA;59;VITORIA-GASTEIZ;1;25;A;484;256;1;255;3;252;228;50;74;;;44;4;;10;0;0;29;2;3;;34;2
ARABA/ÁLAVA;59;VITORIA-GASTEIZ;1;25;B;521;262;4;258;0;258;259;52;72;;;36;2;;4;0;0;44;1;1;;44;2
ARABA/ÁLAVA;59;VITORIA-GASTEIZ;1;26;U;869;503;3;500;3;497;366;113;106;;;89;5;;14;1;0;83;1;2;;82;1
ARABA/ÁLAVA;59;VITORIA-GASTEIZ;1;27;U;924;527;6;521;1;520;397;119;137;;;85;7;;8;3;0;69;4;2;;85;1
ARABA/ÁLAVA;59;VITORIA-GASTEIZ;1;29;U;764;382;5;377;4;373;382;76;108;;;63;4;;13;1;0;56;1;3;;45;3
ARABA/ÁLAVA;59;VITORIA-GASTEIZ;1;30;U;840;542;3;539;2;537;298;156;174;;;65;2;;23;2;0;53;3;2;;56;1
ARABA/ÁLAVA;59;VITORIA-GASTEIZ;1;31;U;845;504;2;502;2;500;341;108;136;;;86;4;;12;1;1;64;5;4;;75;4
ARABA/ÁLAVA;59;VITORIA-GASTEIZ;1;32;U;716;386;6;380;6;374;330;88;108;;;62;4;;11;1;0;32;6;2;;57;3
ARABA/ÁLAVA;59;VITORIA-GASTEIZ;1;33;A;461;274;1;273;3;270;187;68;72;;;53;2;;9;0;0;27;2;0;;35;2
ARABA/ÁLAVA;59;VITORIA-GASTEIZ;1;33;B;504;289;1;288;0;288;215;68;94;;;60;1;;8;0;1;17;1;1;;36;1
ARABA/ÁLAVA;59;VITORIA-GASTEIZ;1;34;U;619;369;1;368;1;367;250;88;78;;;79;4;;22;1;0;31;2;2;;58;2
ARABA/ÁLAVA;59;VITORIA-GASTEIZ;1;35;U;765;422;3;419;1;418;343;88;97;;;101;6;;15;1;0;38;0;2;;69;1
ARABA/ÁLAVA;59;VITORIA-GASTEIZ;1;36;U;797;503;2;501;2;499;294;108;152;;;101;6;;16;0;0;40;3;2;;69;2
ARABA/ÁLAVA;59;VITORIA-GASTEIZ;1;37;U;566;318;7;311;0;311;248;68;74;;;83;4;;13;2;1;21;1;1;;42;1
ARABA/ÁLAVA;59;VITORIA-GASTEIZ;1;38;U;762;435;3;432;1;431;327;78;127;;;105;6;;13;1;0;46;1;2;;50;2
ARABA/ÁLAVA;59;VITORIA-GASTEIZ;1;39;A;451;263;1;262;1;261;188;57;61;;;58;1;;12;0;0;33;4;1;;33;1
ARABA/ÁLAVA;59;VITORIA-GASTEIZ;1;39;B;532;315;1;314;0;314;217;67;92;;;49;6;;17;0;0;40;2;1;;39;1
ARABA/ÁLAVA;59;VITORIA-GASTEIZ;2;1;A;496;320;1;319;2;317;176;124;99;;;18;3;;19;1;0;32;2;0;;18;1
ARABA/ÁLAVA;59;VITORIA-GASTEIZ;2;1;B;500;330;4;326;4;322;170;109;104;;;20;0;;17;2;0;35;5;0;;30;0
ARABA/ÁLAVA;59;VITORIA-GASTEIZ;2;2;A;628;425;3;422;6;416;203;135;156;;;32;2;;23;0;0;37;1;0;;29;1
ARABA/ÁLAVA;59;VITORIA-GASTEIZ;2;2;B;631;440;6;434;1;433;191;126;166;;;37;4;;16;2;0;29;1;0;;50;2
ARABA/ÁLAVA;59;VITORIA-GASTEIZ;2;3;U;832;547;2;545;2;543;285;156;153;;;60;4;;28;2;0;64;5;4;;66;1
ARABA/ÁLAVA;59;VITORIA-GASTEIZ;2;4;A;603;395;2;393;1;392;208;105;112;;;52;3;;15;0;0;54;3;1;;47;0
ARABA/ÁLAVA;59;VITORIA-GASTEIZ;2;4;B;703;456;5;451;3;448;247;130;147;;;52;1;;20;2;2;46;4;3;;40;1
ARABA/ÁLAVA;59;VITORIA-GASTEIZ;2;5;U;816;511;0;511;3;508;305;129;139;;;46;1;;11;1;0;92;2;1;;85;1
ARABA/ÁLAVA;59;VITORIA-GASTEIZ;2;6;A;556;345;1;344;2;342;211;102;90;;;43;1;;9;2;0;52;1;2;;39;1
ARABA/ÁLAVA;59;VITORIA-GASTEIZ;2;6;B;499;317;1;316;4;312;182;82;69;;;43;5;;7;1;0;48;2;0;;54;1
ARABA/ÁLAVA;59;VITORIA-GASTEIZ;2;8;A;521;362;1;361;2;359;159;88;128;;;43;2;;6;3;0;35;2;1;;48;3
ARABA/ÁLAVA;59;VITORIA-GASTEIZ;2;8;B;507;332;0;332;0;332;175;84;110;;;43;1;;14;1;0;27;2;1;;48;1
ARABA/ÁLAVA;59;VITORIA-GASTEIZ;2;9;A;423;267;0;267;0;267;156;64;79;;;35;2;;10;0;1;26;4;0;;45;1
ARABA/ÁLAVA;59;VITORIA-GASTEIZ;2;9;B;446;271;0;271;2;269;175;67;86;;;35;6;;11;0;0;25;3;1;;35;0
ARABA/ÁLAVA;59;VITORIA-GASTEIZ;2;10;A;584;400;3;397;2;395;184;117;116;;;46;3;;12;1;1;42;0;0;;56;1
ARABA/ÁLAVA;59;VITORIA-GASTEIZ;2;10;B;525;359;0;359;1;358;166;87;107;;;48;2;;11;0;0;49;1;0;;53;0
ARABA/ÁLAVA;59;VITORIA-GASTEIZ;2;11;A;468;293;2;291;1;290;175;85;72;;;50;2;;10;0;0;33;2;1;;34;1
ARABA/ÁLAVA;59;VITORIA-GASTEIZ;2;11;B;481;339;1;338;0;338;142;74;109;;;59;0;;8;2;0;40;1;2;;43;0
ARABA/ÁLAVA;59;VITORIA-GASTEIZ;2;12;U;597;400;2;398;4;394;197;104;96;;;41;3;;21;1;0;61;5;1;;60;1
ARABA/ÁLAVA;59;VITORIA-GASTEIZ;2;13;U;731;495;4;491;4;487;236;123;149;;;56;1;;12;2;0;80;2;3;;56;3
ARABA/ÁLAVA;59;VITORIA-GASTEIZ;2;14;A;494;306;4;302;2;300;188;87;85;;;47;1;;2;1;0;37;0;2;;38;0
ARABA/ÁLAVA;59;VITORIA-GASTEIZ;2;14;B;475;294;6;288;1;287;181;62;88;;;39;0;;12;0;1;36;1;1;;47;0
ARABA/ÁLAVA;59;VITORIA-GASTEIZ;2;15;U;726;455;1;454;6;448;271;97;117;;;113;6;;9;0;0;51;3;3;;47;2
ARABA/ÁLAVA;59;VITORIA-GASTEIZ;2;16;A;637;350;3;347;1;346;287;80;78;;;58;5;;10;1;0;53;0;2;;56;3
ARABA/ÁLAVA;59;VITORIA-GASTEIZ;2;16;B;729;415;0;415;2;413;314;91;75;;;49;4;;13;4;1;83;0;3;;89;1
ARABA/ÁLAVA;59;VITORIA-GASTEIZ;2;17;A;656;443;3;440;5;435;213;98;104;;;57;4;;15;2;0;85;1;2;;66;1
ARABA/ÁLAVA;59;VITORIA-GASTEIZ;2;17;B;718;461;2;459;5;454;257;96;97;;;66;8;;13;2;0;69;3;0;;97;3
ARABA/ÁLAVA;59;VITORIA-GASTEIZ;2;18;A;666;438;1;437;0;437;228;119;117;;;60;5;;22;2;0;52;2;3;;53;2
ARABA/ÁLAVA;59;VITORIA-GASTEIZ;2;18;B;716;458;5;453;2;451;258;123;119;;;56;8;;23;1;1;52;1;0;;65;2
ARABA/ÁLAVA;59;VITORIA-GASTEIZ;2;19;U;694;500;2;498;4;494;194;128;154;;;56;3;;22;0;1;65;4;0;;61;0
ARABA/ÁLAVA;59;VITORIA-GASTEIZ;2;20;U;810;552;0;552;1;551;258;156;178;;;60;2;;47;1;0;46;4;1;;56;0
ARABA/ÁLAVA;59;VITORIA-GASTEIZ;2;21;A;622;419;2;417;3;414;203;130;122;;;51;5;;20;0;0;44;1;1;;39;1
ARABA/ÁLAVA;59;VITORIA-GASTEIZ;2;21;B;651;438;6;432;5;427;213;133;121;;;48;5;;16;2;0;53;2;2;;45;0
ARABA/ÁLAVA;59;VITORIA-GASTEIZ;2;22;U;640;461;4;457;1;456;179;129;97;;;55;6;;27;0;1;64;3;1;;72;1
ARABA/ÁLAVA;59;VITORIA-GASTEIZ;2;23;A;762;541;1;540;5;535;221;163;129;;;75;4;;16;2;0;77;1;4;;63;1
ARABA/ÁLAVA;59;VITORIA-GASTEIZ;2;23;B;870;560;3;557;12;545;310;165;102;;;76;8;;18;1;0;87;1;1;;85;1
ARABA/ÁLAVA;59;VITORIA-GASTEIZ;2;24;A;619;453;3;450;4;446;166;113;77;;;72;14;;16;1;0;69;5;1;;77;1
ARABA/ÁLAVA;59;VITORIA-GASTEIZ;2;24;B;609;408;0;408;2;406;201;103;81;;;60;5;;18;2;0;58;0;1;;76;2
ARABA/ÁLAVA;59;VITORIA-GASTEIZ;2;25;A;791;550;4;546;5;541;241;143;121;;;68;5;;24;1;0;88;2;2;;85;2
ARABA/ÁLAVA;59;VITORIA-GASTEIZ;2;25;B;786;555;1;554;4;550;231;137;98;;;57;8;;39;1;0;94;2;3;;109;2
ARABA/ÁLAVA;59;VITORIA-GASTEIZ;2;26;U;691;431;4;427;3;424;260;99;108;;;45;2;;24;2;0;69;1;2;;70;2
ARABA/ÁLAVA;59;VITORIA-GASTEIZ;2;27;U;734;479;4;475;2;473;255;148;98;;;69;7;;24;1;0;52;4;0;;66;4
ARABA/ÁLAVA;59;VITORIA-GASTEIZ;2;28;U;709;417;3;414;1;413;292;100;79;;;71;8;;10;1;1;63;0;6;;73;1
ARABA/ÁLAVA;59;VITORIA-GASTEIZ;2;29;U;618;397;2;395;3;392;221;69;87;;;78;7;;10;0;0;67;2;2;;69;1
ARABA/ÁLAVA;59;VITORIA-GASTEIZ;2;30;A;459;282;1;281;1;280;177;79;36;;;36;5;;9;3;0;45;2;1;;61;3
ARABA/ÁLAVA;59;VITORIA-GASTEIZ;2;30;B;530;339;2;337;3;334;191;86;63;;;49;4;;11;1;1;51;1;0;;64;3
ARABA/ÁLAVA;59;VITORIA-GASTEIZ;2;31;A;504;307;0;307;5;302;197;66;45;;;53;2;;17;1;1;44;0;2;;70;1
ARABA/ÁLAVA;59;VITORIA-GASTEIZ;2;31;B;548;346;4;342;3;339;202;71;53;;;57;3;;21;1;0;69;1;1;;61;1
ARABA/ÁLAVA;59;VITORIA-GASTEIZ;2;32;A;563;355;2;353;3;350;208;97;81;;;52;2;;25;0;0;41;1;1;;47;3
ARABA/ÁLAVA;59;VITORIA-GASTEIZ;2;32;B;584;352;3;349;4;345;232;95;68;;;51;1;;20;0;0;43;2;3;;56;6
ARABA/ÁLAVA;59;VITORIA-GASTEIZ;2;33;U;716;457;0;457;0;457;259;106;218;;;31;1;;28;3;0;43;6;0;;20;1
ARABA/ÁLAVA;59;VITORIA-GASTEIZ;2;34;A;607;431;3;428;1;427;176;131;133;;;37;5;;32;1;0;44;2;2;;37;3
ARABA/ÁLAVA;59;VITORIA-GASTEIZ;2;34;B;521;358;2;356;2;354;163;117;132;;;34;1;;13;1;0;30;8;1;;17;0
ARABA/ÁLAVA;59;VITORIA-GASTEIZ;2;35;A;782;551;2;549;6;543;231;194;225;;;36;1;;26;0;0;40;1;1;;19;0
ARABA/ÁLAVA;59;VITORIA-GASTEIZ;2;35;B;517;347;1;346;3;343;170;110;141;;;19;3;;14;1;0;23;8;0;;24;0
ARABA/ÁLAVA;59;VITORIA-GASTEIZ;2;35;C;532;339;3;336;4;332;193;86;149;;;24;3;;18;1;0;27;0;1;;22;1
ARABA/ÁLAVA;59;VITORIA-GASTEIZ;2;36;A;647;405;6;399;8;391;242;107;76;;;34;9;;22;3;1;74;2;5;;52;6
ARABA/ÁLAVA;59;VITORIA-GASTEIZ;2;36;B;673;417;5;412;3;409;256;117;85;;;52;5;;23;1;1;56;2;6;;57;4
ARABA/ÁLAVA;59;VITORIA-GASTEIZ;2;37;A;593;374;2;372;1;371;219;116;69;;;48;2;;12;3;0;55;6;3;;57;0
ARABA/ÁLAVA;59;VITORIA-GASTEIZ;2;37;B;554;340;2;338;1;337;214;98;67;;;42;5;;17;3;0;48;1;2;;52;2
ARABA/ÁLAVA;59;VITORIA-GASTEIZ;2;37;C;583;355;3;352;2;350;228;99;81;;;45;3;;18;2;0;40;0;2;;59;1
ARABA/ÁLAVA;59;VITORIA-GASTEIZ;2;38;A;641;356;2;354;3;351;285;78;44;;;42;11;;18;1;0;67;1;2;;83;4
ARABA/ÁLAVA;59;VITORIA-GASTEIZ;2;38;B;587;331;4;327;3;324;256;82;41;;;40;1;;9;2;1;57;0;3;;86;2
ARABA/ÁLAVA;59;VITORIA-GASTEIZ;2;39;A;577;355;3;352;3;349;222;81;45;;;42;3;;12;2;0;66;1;7;;88;2
ARABA/ÁLAVA;59;VITORIA-GASTEIZ;2;39;B;583;360;4;356;2;354;223;93;45;;;40;3;;15;2;0;57;3;2;;91;3
ARABA/ÁLAVA;59;VITORIA-GASTEIZ;2;40;A;686;357;3;354;2;352;329;92;52;;;40;4;;6;3;0;63;1;3;;84;4
ARABA/ÁLAVA;59;VITORIA-GASTEIZ;2;40;B;659;317;1;316;2;314;342;73;48;;;36;8;;13;2;0;44;2;4;;82;2
ARABA/ÁLAVA;59;VITORIA-GASTEIZ;2;41;A;614;313;3;310;4;306;301;76;32;;;39;3;;7;2;0;64;1;3;;77;2
ARABA/ÁLAVA;59;VITORIA-GASTEIZ;2;41;B;619;344;4;340;3;337;275;75;29;;;42;4;;7;2;0;71;1;5;;99;2
ARABA/ÁLAVA;59;VITORIA-GASTEIZ;2;41;C;618;327;3;324;2;322;291;68;36;;;31;6;;5;2;0;79;1;2;;89;3
ARABA/ÁLAVA;59;VITORIA-GASTEIZ;2;42;A;656;354;4;350;2;348;302;87;24;;;41;7;;14;1;0;72;1;1;;96;4
ARABA/ÁLAVA;59;VITORIA-GASTEIZ;2;42;B;634;353;3;350;4;346;281;62;32;;;43;4;;13;1;0;73;0;5;;111;2
ARABA/ÁLAVA;59;VITORIA-GASTEIZ;2;43;A;630;341;1;340;1;339;289;92;47;;;35;5;;18;1;0;52;1;2;;82;4
ARABA/ÁLAVA;59;VITORIA-GASTEIZ;2;43;B;618;350;0;350;4;346;268;77;38;;;38;6;;13;1;1;81;0;5;;84;2
ARABA/ÁLAVA;59;VITORIA-GASTEIZ;2;43;C;603;353;1;352;3;349;250;97;32;;;38;5;;20;0;0;82;0;1;;70;4
ARABA/ÁLAVA;59;VITORIA-GASTEIZ;2;44;A;664;387;3;384;5;379;277;83;28;;;47;3;;24;2;0;95;0;3;;90;4
ARABA/ÁLAVA;59;VITORIA-GASTEIZ;2;44;B;641;374;5;369;5;364;267;77;33;;;48;5;;13;0;2;75;1;7;;100;3
ARABA/ÁLAVA;59;VITORIA-GASTEIZ;2;45;A;613;338;0;338;3;335;275;68;38;;;35;9;;19;2;0;66;2;3;;92;1
ARABA/ÁLAVA;59;VITORIA-GASTEIZ;2;45;B;607;342;1;341;3;338;265;71;30;;;33;10;;13;3;0;71;0;1;;106;0
ARABA/ÁLAVA;59;VITORIA-GASTEIZ;2;46;A;785;481;7;474;8;466;304;116;44;;;35;9;;17;1;0;101;0;1;;137;5
ARABA/ÁLAVA;59;VITORIA-GASTEIZ;2;46;B;789;480;3;477;3;474;309;92;38;;;44;9;;24;3;0;114;5;8;;131;6
ARABA/ÁLAVA;59;VITORIA-GASTEIZ;3;1;A;679;407;2;405;4;401;272;100;69;;;66;7;;5;3;0;88;3;1;;59;0
ARABA/ÁLAVA;59;VITORIA-GASTEIZ;3;1;B;678;413;3;410;3;407;265;92;84;;;70;2;;9;0;0;86;2;1;;61;0
ARABA/ÁLAVA;59;VITORIA-GASTEIZ;3;2;A;427;234;1;233;2;231;193;47;55;;;51;2;;6;0;0;32;1;1;;33;3
ARABA/ÁLAVA;59;VITORIA-GASTEIZ;3;2;B;505;287;1;286;3;283;218;62;54;;;69;4;;8;3;0;40;4;1;;37;1
ARABA/ÁLAVA;59;VITORIA-GASTEIZ;3;3;U;857;469;4;465;2;463;388;74;143;;;127;1;;14;1;1;31;2;3;;66;0
ARABA/ÁLAVA;59;VITORIA-GASTEIZ;3;4;U;856;507;5;502;2;500;349;106;112;;;131;6;;9;0;0;55;6;5;;69;1
ARABA/ÁLAVA;59;VITORIA-GASTEIZ;3;5;U;648;346;2;344;3;341;302;72;77;;;84;1;;9;0;0;35;2;1;;60;0
ARABA/ÁLAVA;59;VITORIA-GASTEIZ;3;6;A;502;260;2;258;0;258;242;59;49;;;81;0;;5;1;1;31;0;1;;30;0
ARABA/ÁLAVA;59;VITORIA-GASTEIZ;3;6;B;465;253;0;253;3;250;212;42;43;;;68;0;;4;1;1;40;0;2;;49;0
ARABA/ÁLAVA;59;VITORIA-GASTEIZ;3;8;U;563;300;2;298;6;292;263;55;54;;;83;0;;13;0;0;33;0;0;;53;1
ARABA/ÁLAVA;59;VITORIA-GASTEIZ;3;9;U;726;411;1;410;2;408;315;80;66;;;130;4;;10;2;0;48;3;4;;60;1
ARABA/ÁLAVA;59;VITORIA-GASTEIZ;3;10;U;628;349;2;347;4;343;279;83;93;;;70;2;;8;0;0;21;5;0;;59;2
ARABA/ÁLAVA;59;VITORIA-GASTEIZ;3;11;A;460;255;0;255;4;251;205;50;50;;;57;4;;2;0;2;26;6;2;;52;0
ARABA/ÁLAVA;59;VITORIA-GASTEIZ;3;11;B;445;246;3;243;4;239;199;43;46;;;53;3;;7;0;0;30;4;0;;53;0
ARABA/ÁLAVA;59;VITORIA-GASTEIZ;3;12;U;772;468;3;465;4;461;304;109;90;;;87;2;;15;0;2;74;3;2;;74;3
ARABA/ÁLAVA;59;VITORIA-GASTEIZ;3;13;U;700;406;5;401;0;401;294;99;79;;;68;3;;16;1;0;59;2;5;;67;2
ARABA/ÁLAVA;59;VITORIA-GASTEIZ;3;14;A;731;420;3;417;2;415;311;83;69;;;87;3;;19;2;1;61;1;4;;81;4
ARABA/ÁLAVA;59;VITORIA-GASTEIZ;3;14;B;704;431;7;424;3;421;273;76;76;;;85;3;;8;4;1;90;2;3;;72;1
ARABA/ÁLAVA;59;VITORIA-GASTEIZ;3;15;A;612;351;0;351;7;344;261;71;81;;;68;1;;6;1;0;47;0;0;;69;0
ARABA/ÁLAVA;59;VITORIA-GASTEIZ;3;15;B;625;358;5;353;2;351;267;86;86;;;76;6;;12;1;0;36;1;3;;44;0
ARABA/ÁLAVA;59;VITORIA-GASTEIZ;3;16;A;531;338;3;335;2;333;193;73;50;;;69;2;;7;1;0;54;3;5;;67;2
ARABA/ÁLAVA;59;VITORIA-GASTEIZ;3;16;B;572;334;6;328;6;322;238;57;57;;;73;5;;11;1;0;60;1;1;;53;3
ARABA/ÁLAVA;59;VITORIA-GASTEIZ;3;17;U;599;366;1;365;3;362;233;80;79;;;68;5;;15;0;0;40;2;3;;69;1
ARABA/ÁLAVA;59;VITORIA-GASTEIZ;3;18;A;504;302;1;301;4;297;202;60;87;;;44;5;;6;1;0;44;2;4;;41;3
ARABA/ÁLAVA;59;VITORIA-GASTEIZ;3;18;B;546;340;1;339;3;336;206;71;89;;;64;4;;13;1;0;58;0;0;;36;0
ARABA/ÁLAVA;59;VITORIA-GASTEIZ;3;19;U;850;506;3;503;2;501;344;104;126;;;88;3;;17;1;0;62;0;7;;92;1
ARABA/ÁLAVA;59;VITORIA-GASTEIZ;3;20;U;798;479;3;476;1;475;319;116;93;;;96;4;;15;1;1;68;0;2;;76;3
ARABA/ÁLAVA;59;VITORIA-GASTEIZ;3;21;U;559;370;0;370;0;370;189;88;77;;;78;5;;14;1;0;43;1;2;;57;4
ARABA/ÁLAVA;59;VITORIA-GASTEIZ;3;22;U;591;334;1;333;2;331;257;86;61;;;55;2;;14;1;1;46;5;1;;58;1
ARABA/ÁLAVA;59;VITORIA-GASTEIZ;3;23;A;536;315;5;310;3;307;221;97;51;;;44;1;;7;2;1;59;1;1;;41;2
ARABA/ÁLAVA;59;VITORIA-GASTEIZ;3;23;B;539;308;3;305;0;305;231;93;62;;;25;6;;9;1;0;54;3;3;;49;0
ARABA/ÁLAVA;59;VITORIA-GASTEIZ;3;25;U;819;534;3;531;4;527;285;164;146;;;60;3;;12;1;0;81;2;2;;56;0
ARABA/ÁLAVA;59;VITORIA-GASTEIZ;3;26;A;659;411;6;405;3;402;248;107;94;;;40;2;;11;1;0;85;2;1;;58;1
ARABA/ÁLAVA;59;VITORIA-GASTEIZ;3;26;B;694;426;2;424;4;420;268;101;87;;;50;2;;15;1;1;91;4;1;;64;3
ARABA/ÁLAVA;59;VITORIA-GASTEIZ;3;27;A;550;361;5;356;0;356;189;87;72;;;51;4;;12;2;0;72;2;0;;54;0
ARABA/ÁLAVA;59;VITORIA-GASTEIZ;3;27;B;617;406;2;404;1;403;211;110;88;;;57;0;;15;0;0;78;1;1;;51;2
ARABA/ÁLAVA;59;VITORIA-GASTEIZ;3;28;A;496;318;3;315;2;313;178;80;70;;;43;3;;12;2;0;56;0;2;;44;1
ARABA/ÁLAVA;59;VITORIA-GASTEIZ;3;28;B;582;357;4;353;3;350;225;83;80;;;62;6;;19;2;0;46;1;0;;49;2
ARABA/ÁLAVA;59;VITORIA-GASTEIZ;3;29;U;710;475;6;469;3;466;235;138;88;;;57;3;;8;2;0;107;2;1;;59;1
ARABA/ÁLAVA;59;VITORIA-GASTEIZ;3;30;U;672;380;2;378;1;377;292;95;66;;;84;3;;16;0;0;57;5;1;;48;2
ARABA/ÁLAVA;59;VITORIA-GASTEIZ;3;31;U;541;295;8;287;2;285;246;71;55;;;50;5;;7;0;1;35;2;0;;57;2
ARABA/ÁLAVA;59;VITORIA-GASTEIZ;3;32;A;525;289;0;289;0;289;236;55;63;;;61;2;;5;0;0;32;4;3;;63;1
ARABA/ÁLAVA;59;VITORIA-GASTEIZ;3;32;B;541;295;1;294;0;294;246;61;70;;;80;1;;2;0;1;37;1;2;;38;1
ARABA/ÁLAVA;59;VITORIA-GASTEIZ;3;34;A;591;390;2;388;2;386;201;104;87;;;55;1;;10;2;0;69;2;3;;51;2
ARABA/ÁLAVA;59;VITORIA-GASTEIZ;3;34;B;639;384;5;379;3;376;255;92;69;;;63;2;;16;0;0;69;4;1;;55;5
ARABA/ÁLAVA;59;VITORIA-GASTEIZ;3;35;A;799;411;1;410;1;409;388;86;53;;;58;6;;9;2;2;90;0;6;;92;5
ARABA/ÁLAVA;59;VITORIA-GASTEIZ;3;35;B;774;390;1;389;3;386;384;97;54;;;46;11;;8;0;0;72;0;0;;95;3
ARABA/ÁLAVA;59;VITORIA-GASTEIZ;3;36;A;744;435;3;432;2;430;309;110;50;;;58;5;;8;0;0;90;1;0;;105;3
ARABA/ÁLAVA;59;VITORIA-GASTEIZ;3;36;B;728;434;3;431;5;426;294;108;56;;;31;7;;12;1;0;88;1;4;;112;6
ARABA/ÁLAVA;59;VITORIA-GASTEIZ;3;37;A;582;333;1;332;4;328;249;83;40;;;31;2;;12;2;1;60;1;5;;86;5
ARABA/ÁLAVA;59;VITORIA-GASTEIZ;3;37;B;619;367;3;364;2;362;252;96;52;;;30;2;;12;2;0;84;1;3;;77;3
ARABA/ÁLAVA;59;VITORIA-GASTEIZ;3;38;A;699;427;5;422;8;414;272;111;42;;;45;7;;21;1;1;83;2;4;;96;1
ARABA/ÁLAVA;59;VITORIA-GASTEIZ;3;38;B;703;462;6;456;4;452;241;101;41;;;55;4;;23;1;0;112;0;8;;106;1
ARABA/ÁLAVA;59;VITORIA-GASTEIZ;3;39;A;608;333;1;332;3;329;275;77;41;;;32;2;;10;0;1;75;0;4;;81;6
ARABA/ÁLAVA;59;VITORIA-GASTEIZ;3;39;B;579;322;4;318;1;317;257;72;50;;;29;4;;7;2;0;90;1;2;;60;0
ARABA/ÁLAVA;59;VITORIA-GASTEIZ;3;40;A;504;316;5;311;6;305;188;65;32;;;29;3;;10;0;0;74;3;3;;82;4
ARABA/ÁLAVA;59;VITORIA-GASTEIZ;3;40;B;573;341;4;337;2;335;232;81;26;;;31;9;;14;1;0;77;1;4;;86;5
ARABA/ÁLAVA;59;VITORIA-GASTEIZ;3;41;A;824;502;6;496;3;493;322;109;49;;;46;13;;18;2;0;113;1;6;;132;4
ARABA/ÁLAVA;59;VITORIA-GASTEIZ;3;41;B;821;525;4;521;3;518;296;137;49;;;49;7;;6;2;1;109;0;9;;145;4
ARABA/ÁLAVA;59;VITORIA-GASTEIZ;3;42;A;761;404;5;399;3;396;357;81;43;;;44;7;;13;3;0;83;2;3;;114;3
ARABA/ÁLAVA;59;VITORIA-GASTEIZ;3;42;B;721;388;6;382;3;379;333;85;34;;;43;10;;9;1;0;78;2;6;;107;4
ARABA/ÁLAVA;59;VITORIA-GASTEIZ;3;42;C;742;400;4;396;4;392;342;85;42;;;46;10;;8;1;0;70;0;6;;120;4
ARABA/ÁLAVA;59;VITORIA-GASTEIZ;4;1;A;510;347;2;345;2;343;163;111;114;;;43;6;;3;1;0;30;2;1;;32;0
ARABA/ÁLAVA;59;VITORIA-GASTEIZ;4;1;B;466;312;2;310;1;309;154;96;96;;;33;3;;13;0;0;34;2;2;;30;0
ARABA/ÁLAVA;59;VITORIA-GASTEIZ;4;2;U;724;480;4;476;0;476;244;155;158;;;53;3;;12;0;0;48;0;1;;46;0
ARABA/ÁLAVA;59;VITORIA-GASTEIZ;4;4;U;870;548;2;546;5;541;322;170;159;;;63;5;;20;2;0;60;3;2;;54;3
ARABA/ÁLAVA;59;VITORIA-GASTEIZ;4;5;A;473;335;2;333;1;332;138;115;95;;;22;2;;9;0;0;50;1;4;;34;0
ARABA/ÁLAVA;59;VITORIA-GASTEIZ;4;5;B;491;357;2;355;0;355;134;108;103;;;27;1;;16;0;0;54;4;0;;41;1
ARABA/ÁLAVA;59;VITORIA-GASTEIZ;4;6;A;635;418;3;415;2;413;217;114;68;;;75;2;;16;0;0;76;1;2;;59;0
ARABA/ÁLAVA;59;VITORIA-GASTEIZ;4;6;B;686;446;4;442;2;440;240;111;91;;;71;8;;9;2;1;78;3;5;;56;5
ARABA/ÁLAVA;59;VITORIA-GASTEIZ;4;7;A;465;296;0;296;2;294;169;83;66;;;29;0;;7;3;0;59;1;1;;45;0
ARABA/ÁLAVA;59;VITORIA-GASTEIZ;4;7;B;505;322;4;318;1;317;183;69;72;;;41;3;;10;2;0;70;1;2;;46;1
ARABA/ÁLAVA;59;VITORIA-GASTEIZ;4;8;A;448;286;3;283;3;280;162;72;62;;;42;4;;8;1;0;43;0;4;;41;3
ARABA/ÁLAVA;59;VITORIA-GASTEIZ;4;8;B;464;276;1;275;2;273;188;89;65;;;35;4;;3;0;0;37;0;1;;35;4
ARABA/ÁLAVA;59;VITORIA-GASTEIZ;4;9;U;655;459;3;456;0;456;196;135;104;;;44;4;;10;0;0;93;4;2;;59;1
ARABA/ÁLAVA;59;VITORIA-GASTEIZ;4;10;U;751;450;4;446;1;445;301;111;81;;;81;4;;15;0;0;75;0;3;;74;1
ARABA/ÁLAVA;59;VITORIA-GASTEIZ;4;12;A;516;308;1;307;4;303;208;74;49;;;45;5;;8;1;1;66;2;1;;50;1
ARABA/ÁLAVA;59;VITORIA-GASTEIZ;4;12;B;505;295;3;292;2;290;210;75;50;;;36;5;;5;0;0;61;2;2;;54;0
ARABA/ÁLAVA;59;VITORIA-GASTEIZ;4;14;U;547;343;1;342;1;341;204;83;50;;;57;4;;13;1;0;68;1;4;;59;1
ARABA/ÁLAVA;59;VITORIA-GASTEIZ;4;15;U;848;515;6;509;1;508;333;129;83;;;105;4;;18;0;1;65;0;4;;97;2
ARABA/ÁLAVA;59;VITORIA-GASTEIZ;4;16;A;585;346;3;343;2;341;239;76;58;;;55;4;;7;1;2;71;2;4;;61;0
ARABA/ÁLAVA;59;VITORIA-GASTEIZ;4;16;B;712;450;3;447;5;442;262;111;89;;;54;3;;12;1;2;87;2;5;;73;3
ARABA/ÁLAVA;59;VITORIA-GASTEIZ;4;17;A;496;316;1;315;5;310;180;80;58;;;49;1;;4;1;0;59;1;3;;53;1
ARABA/ÁLAVA;59;VITORIA-GASTEIZ;4;17;B;561;377;1;376;0;376;184;110;64;;;59;4;;9;2;0;65;3;0;;59;1
ARABA/ÁLAVA;59;VITORIA-GASTEIZ;4;18;U;827;499;3;496;4;492;328;112;96;;;90;3;;12;1;0;77;1;5;;89;6
ARABA/ÁLAVA;59;VITORIA-GASTEIZ;4;19;A;421;260;2;258;1;257;161;61;44;;;42;0;;10;1;0;53;0;4;;41;1
ARABA/ÁLAVA;59;VITORIA-GASTEIZ;4;19;B;516;339;2;337;7;330;177;77;55;;;64;4;;6;1;0;51;0;3;;68;1
ARABA/ÁLAVA;59;VITORIA-GASTEIZ;4;20;A;435;290;0;290;1;289;145;56;38;;;53;5;;15;0;0;66;0;0;;55;1
ARABA/ÁLAVA;59;VITORIA-GASTEIZ;4;20;B;505;293;1;292;0;292;212;64;43;;;45;4;;9;0;1;71;0;3;;51;1
ARABA/ÁLAVA;59;VITORIA-GASTEIZ;4;21;A;568;368;1;367;3;364;200;82;63;;;75;4;;11;0;1;64;1;3;;60;0
ARABA/ÁLAVA;59;VITORIA-GASTEIZ;4;21;B;534;334;5;329;1;328;200;75;52;;;56;4;;19;0;0;57;4;3;;57;1
ARABA/ÁLAVA;59;VITORIA-GASTEIZ;4;22;A;456;269;2;267;1;266;187;59;43;;;49;1;;9;0;0;51;0;1;;52;1
ARABA/ÁLAVA;59;VITORIA-GASTEIZ;4;22;B;480;291;2;289;1;288;189;69;46;;;56;3;;10;0;0;46;0;2;;55;1
ARABA/ÁLAVA;59;VITORIA-GASTEIZ;4;23;U;588;288;4;284;2;282;300;66;46;;;60;1;;5;1;0;50;0;4;;46;3
ARABA/ÁLAVA;59;VITORIA-GASTEIZ;4;24;U;707;402;0;402;1;401;305;99;95;;;76;3;;17;1;0;53;1;3;;50;3
ARABA/ÁLAVA;59;VITORIA-GASTEIZ;4;25;A;729;416;3;413;2;411;313;105;73;;;64;5;;9;0;0;69;2;3;;81;0
ARABA/ÁLAVA;59;VITORIA-GASTEIZ;4;25;B;811;461;1;460;3;457;350;117;85;;;78;3;;11;1;1;68;1;3;;84;5
ARABA/ÁLAVA;59;VITORIA-GASTEIZ;4;26;A;465;288;0;288;1;287;177;61;65;;;58;4;;11;0;0;42;0;0;;44;2
ARABA/ÁLAVA;59;VITORIA-GASTEIZ;4;26;B;551;348;0;348;3;345;203;84;78;;;60;2;;7;1;0;58;1;4;;48;2
ARABA/ÁLAVA;59;VITORIA-GASTEIZ;4;27;U;612;354;2;352;5;347;258;89;65;;;45;3;;15;0;0;86;1;1;;41;1
ARABA/ÁLAVA;59;VITORIA-GASTEIZ;4;28;A;449;288;7;281;1;280;161;69;71;;;41;4;;13;1;0;48;2;1;;30;0
ARABA/ÁLAVA;59;VITORIA-GASTEIZ;4;28;B;442;276;1;275;2;273;166;56;68;;;47;4;;6;1;0;52;1;3;;34;1
ARABA/ÁLAVA;59;VITORIA-GASTEIZ;4;29;A;471;279;1;278;4;274;192;66;75;;;54;3;;12;0;0;26;2;1;;33;2
ARABA/ÁLAVA;59;VITORIA-GASTEIZ;4;29;B;504;278;4;274;1;273;226;56;59;;;67;5;;11;0;0;33;0;1;;41;0
ARABA/ÁLAVA;59;VITORIA-GASTEIZ;4;31;A;623;379;1;378;2;376;244;76;89;;;47;3;;19;0;0;63;6;3;;69;1
ARABA/ÁLAVA;59;VITORIA-GASTEIZ;4;31;B;642;388;0;388;7;381;254;86;84;;;60;3;;17;3;0;50;8;5;;63;2
ARABA/ÁLAVA;59;VITORIA-GASTEIZ;4;32;U;695;476;6;470;3;467;219;130;75;;;35;15;;13;3;0;114;3;2;;74;3
ARABA/ÁLAVA;59;VITORIA-GASTEIZ;5;1;U;719;395;0;395;0;395;324;107;71;;;54;9;;18;0;0;56;2;3;;73;2
ARABA/ÁLAVA;59;VITORIA-GASTEIZ;5;2;A;494;288;2;286;0;286;206;65;59;;;46;2;;8;1;2;32;7;1;;62;1
ARABA/ÁLAVA;59;VITORIA-GASTEIZ;5;2;B;493;287;3;284;3;281;206;55;63;;;59;5;;10;0;0;31;5;1;;52;0
ARABA/ÁLAVA;59;VITORIA-GASTEIZ;5;3;U;834;431;1;430;5;425;403;85;96;;;97;2;;16;0;0;50;3;1;;75;0
ARABA/ÁLAVA;59;VITORIA-GASTEIZ;5;4;U;514;300;6;294;3;291;214;68;71;;;56;3;;16;0;0;29;4;1;;39;4
ARABA/ÁLAVA;59;VITORIA-GASTEIZ;5;5;U;855;380;0;380;3;377;475;54;92;;;73;9;;16;0;1;36;1;3;;91;1
ARABA/ÁLAVA;59;VITORIA-GASTEIZ;5;6;A;557;161;0;161;1;160;396;65;18;;;51;1;;5;1;1;14;0;0;;4;0
ARABA/ÁLAVA;59;VITORIA-GASTEIZ;5;6;B;338;159;0;159;2;157;179;27;32;;;45;2;;3;1;1;22;0;2;;21;1
ARABA/ÁLAVA;59;VITORIA-GASTEIZ;5;7;A;736;431;5;426;2;424;305;85;83;;;84;7;;21;2;1;54;1;2;;80;4
ARABA/ÁLAVA;59;VITORIA-GASTEIZ;5;7;B;801;484;5;479;6;473;317;103;66;;;87;4;;29;0;0;62;4;2;;111;5
ARABA/ÁLAVA;59;VITORIA-GASTEIZ;5;8;U;826;461;4;457;5;452;365;115;47;;;69;3;;21;3;0;84;0;1;;105;4
ARABA/ÁLAVA;59;VITORIA-GASTEIZ;5;9;A;752;439;4;435;8;427;313;106;61;;;75;4;;19;1;0;62;0;3;;94;2
ARABA/ÁLAVA;59;VITORIA-GASTEIZ;5;9;B;760;419;5;414;0;414;341;96;57;;;65;10;;17;2;0;65;4;3;;93;2
ARABA/ÁLAVA;59;VITORIA-GASTEIZ;5;10;U;887;521;8;513;7;506;366;147;73;;;54;5;;25;2;1;101;0;2;;95;1
ARABA/ÁLAVA;59;VITORIA-GASTEIZ;5;11;U;636;379;2;377;5;372;257;84;46;;;67;8;;20;2;1;54;2;2;;84;2
ARABA/ÁLAVA;59;VITORIA-GASTEIZ;5;12;A;778;501;3;498;8;490;277;114;101;;;77;4;;28;8;0;52;1;1;;101;3
ARABA/ÁLAVA;59;VITORIA-GASTEIZ;5;12;B;782;475;6;469;6;463;307;101;79;;;104;3;;20;0;1;60;1;6;;85;3
ARABA/ÁLAVA;59;VITORIA-GASTEIZ;5;13;A;685;399;1;398;1;397;286;83;80;;;54;6;;21;0;2;67;5;0;;76;3
ARABA/ÁLAVA;59;VITORIA-GASTEIZ;5;13;B;697;413;2;411;3;408;284;99;94;;;61;4;;24;0;0;52;8;0;;65;1
ARABA/ÁLAVA;59;VITORIA-GASTEIZ;5;14;A;449;293;3;290;0;290;156;68;52;;;46;3;;25;0;0;40;4;3;;48;1
ARABA/ÁLAVA;59;VITORIA-GASTEIZ;5;14;B;486;270;3;267;3;264;216;67;46;;;44;4;;13;0;0;34;0;1;;55;0
ARABA/ÁLAVA;59;VITORIA-GASTEIZ;5;15;U;807;534;2;532;1;531;273;117;113;;;64;5;;30;1;0;76;3;3;;114;5
ARABA/ÁLAVA;59;VITORIA-GASTEIZ;5;16;A;503;296;3;293;1;292;207;50;44;;;56;4;;10;1;0;38;4;4;;80;1
ARABA/ÁLAVA;59;VITORIA-GASTEIZ;5;16;B;555;346;8;338;3;335;209;82;50;;;59;4;;9;3;0;49;3;2;;74;0
ARABA/ÁLAVA;59;VITORIA-GASTEIZ;5;17;A;605;400;5;395;3;392;205;80;58;;;56;9;;18;4;0;64;1;2;;97;3
ARABA/ÁLAVA;59;VITORIA-GASTEIZ;5;17;B;581;398;4;394;6;388;183;100;35;;;58;5;;17;1;0;72;1;1;;96;2
ARABA/ÁLAVA;59;VITORIA-GASTEIZ;5;18;U;688;425;6;419;7;412;263;113;61;;;72;2;;12;0;0;53;1;3;;92;3
ARABA/ÁLAVA;59;VITORIA-GASTEIZ;5;19;U;859;487;4;483;4;479;372;132;84;;;93;3;;14;1;0;53;1;6;;91;1
ARABA/ÁLAVA;59;VITORIA-GASTEIZ;5;20;U;617;389;0;389;1;388;228;94;52;;;82;5;;14;0;2;49;1;1;;83;5
ARABA/ÁLAVA;59;VITORIA-GASTEIZ;5;21;A;529;320;4;316;1;315;209;71;59;;;58;3;;8;1;0;35;0;0;;79;1
ARABA/ÁLAVA;59;VITORIA-GASTEIZ;5;21;B;612;352;6;346;2;344;260;77;57;;;63;9;;6;1;2;37;1;2;;86;3
ARABA/ÁLAVA;59;VITORIA-GASTEIZ;5;22;A;611;332;4;328;0;328;279;67;59;;;50;8;;12;0;0;57;3;1;;69;2
ARABA/ÁLAVA;59;VITORIA-GASTEIZ;5;22;B;652;370;6;364;3;361;282;80;72;;;53;3;;13;1;2;52;5;3;;76;1
ARABA/ÁLAVA;59;VITORIA-GASTEIZ;5;23;A;672;335;2;333;2;331;337;79;50;;;70;3;;7;2;0;44;2;1;;70;3
ARABA/ÁLAVA;59;VITORIA-GASTEIZ;5;23;B;679;343;1;342;0;342;336;70;52;;;95;2;;5;1;0;53;0;6;;57;1
ARABA/ÁLAVA;59;VITORIA-GASTEIZ;5;25;A;606;325;13;312;2;310;281;69;45;;;71;3;;9;1;1;55;0;0;;55;1
ARABA/ÁLAVA;59;VITORIA-GASTEIZ;5;25;B;668;359;5;354;3;351;309;71;40;;;94;5;;9;0;2;63;0;6;;59;2
ARABA/ÁLAVA;59;VITORIA-GASTEIZ;5;26;U;890;520;5;515;2;513;370;102;98;;;93;6;;25;0;1;61;0;0;;125;2
ARABA/ÁLAVA;59;VITORIA-GASTEIZ;5;27;A;686;425;0;425;0;425;261;120;83;;;63;3;;15;1;0;56;1;0;;82;1
ARABA/ÁLAVA;59;VITORIA-GASTEIZ;5;27;B;747;456;4;452;5;447;291;115;85;;;79;5;;14;3;1;66;5;2;;70;2
ARABA/ÁLAVA;59;VITORIA-GASTEIZ;5;28;A;649;395;7;388;2;386;254;106;65;;;56;7;;20;0;0;44;4;4;;80;0
ARABA/ÁLAVA;59;VITORIA-GASTEIZ;5;28;B;641;373;1;372;1;371;268;108;41;;;66;7;;14;1;0;57;0;5;;71;1
ARABA/ÁLAVA;59;VITORIA-GASTEIZ;5;29;A;528;309;6;303;3;300;219;78;52;;;37;1;;18;0;3;52;2;2;;53;2
ARABA/ÁLAVA;59;VITORIA-GASTEIZ;5;29;B;577;336;5;331;3;328;241;86;57;;;46;0;;17;0;1;52;0;3;;66;0
ARABA/ÁLAVA;59;VITORIA-GASTEIZ;5;30;U;820;467;3;464;3;461;353;134;79;;;60;4;;22;3;0;68;1;0;;90;0
ARABA/ÁLAVA;59;VITORIA-GASTEIZ;5;31;A;621;357;3;354;2;352;264;81;75;;;55;3;;18;1;0;38;2;4;;74;1
ARABA/ÁLAVA;59;VITORIA-GASTEIZ;5;31;B;650;373;6;367;4;363;277;107;57;;;57;5;;12;1;0;40;1;3;;78;2
ARABA/ÁLAVA;59;VITORIA-GASTEIZ;5;32;A;664;379;3;376;5;371;285;90;74;;;38;5;;21;0;2;50;3;6;;82;0
ARABA/ÁLAVA;59;VITORIA-GASTEIZ;5;32;B;713;399;3;396;5;391;314;104;66;;;25;5;;16;1;0;58;1;7;;105;3
ARABA/ÁLAVA;59;VITORIA-GASTEIZ;5;33;A;572;339;4;335;2;333;233;73;34;;;38;6;;14;2;1;64;2;7;;89;3
ARABA/ÁLAVA;59;VITORIA-GASTEIZ;5;33;B;539;339;1;338;9;329;200;76;36;;;40;1;;10;1;1;60;2;4;;93;5
ARABA/ÁLAVA;59;VITORIA-GASTEIZ;5;34;A;514;316;1;315;1;314;198;95;54;;;46;5;;12;1;0;39;0;1;;59;2
ARABA/ÁLAVA;59;VITORIA-GASTEIZ;5;34;B;502;311;4;307;6;301;191;100;51;;;43;1;;11;0;0;33;1;3;;57;1
ARABA/ÁLAVA;59;VITORIA-GASTEIZ;5;35;U;671;392;9;383;2;381;279;76;48;;;43;9;;16;1;0;92;3;5;;85;3
ARABA/ÁLAVA;59;VITORIA-GASTEIZ;5;36;U;826;398;4;394;2;392;428;93;57;;;42;7;;13;0;0;82;2;0;;91;5
ARABA/ÁLAVA;59;VITORIA-GASTEIZ;5;37;A;540;295;1;294;1;293;245;76;57;;;43;8;;17;2;0;23;3;2;;60;2
ARABA/ÁLAVA;59;VITORIA-GASTEIZ;5;37;B;519;301;1;300;1;299;218;86;62;;;39;3;;13;0;0;39;5;3;;49;0
ARABA/ÁLAVA;59;VITORIA-GASTEIZ;5;38;U;892;537;3;534;6;528;355;144;103;;;98;1;;23;3;0;48;1;6;;96;5
ARABA/ÁLAVA;59;VITORIA-GASTEIZ;6;1;A;436;227;2;225;1;224;209;73;48;;;21;0;;5;2;0;36;1;2;;35;1
ARABA/ÁLAVA;59;VITORIA-GASTEIZ;6;1;B;492;278;4;274;0;274;214;86;59;;;30;4;;13;0;0;31;0;8;;43;0
ARABA/ÁLAVA;59;VITORIA-GASTEIZ;6;1;C;624;359;2;357;5;352;265;117;60;;;21;10;;16;1;0;68;0;2;;56;1
ARABA/ÁLAVA;59;VITORIA-GASTEIZ;6;2;A;328;213;2;211;1;210;115;64;43;;;13;1;;11;1;0;51;1;0;;25;0
ARABA/ÁLAVA;59;VITORIA-GASTEIZ;6;2;B;272;188;0;188;1;187;84;50;76;;;13;2;;3;0;0;30;0;0;;13;0
ARABA/ÁLAVA;59;VITORIA-GASTEIZ;6;2;C;398;225;2;223;1;222;173;72;40;;;13;1;;10;0;0;61;2;2;;21;0
ARABA/ÁLAVA;59;VITORIA-GASTEIZ;6;3;A;386;202;1;201;2;199;184;72;24;;;20;4;;8;0;1;48;0;1;;21;0
ARABA/ÁLAVA;59;VITORIA-GASTEIZ;6;3;B;540;317;2;315;0;315;223;120;32;;;24;3;;13;0;0;72;1;0;;50;0
ARABA/ÁLAVA;59;VITORIA-GASTEIZ;6;3;C;285;150;0;150;1;149;135;52;27;;;11;1;;3;1;0;22;0;2;;28;2
ARABA/ÁLAVA;60;YÉCORA/IEKORA;1;1;U;200;146;3;143;0;143;54;56;47;;;7;1;;6;2;0;8;0;1;;15;0
ARABA/ÁLAVA;61;ZALDUONDO;1;1;U;154;123;2;121;0;121;31;45;2;;;3;1;;2;0;0;49;0;1;;18;0
ARABA/ÁLAVA;62;ZAMBRANA;1;1;U;309;165;0;165;1;164;144;50;40;;;15;1;;10;0;0;22;0;1;;25;0
ARABA/ÁLAVA;63;ZUIA;1;1;A;902;612;2;610;10;600;290;251;59;;;41;5;;8;2;2;145;5;3;;78;1
ARABA/ÁLAVA;63;ZUIA;1;1;B;894;619;3;616;4;612;275;218;67;;;39;3;;14;3;0;188;4;3;;72;1
ARABA/ÁLAVA;901;IRUÑA OKA/IRUÑA DE OCA;1;1;A;852;483;8;475;3;472;369;112;82;;;90;10;;19;1;1;57;6;9;;81;4
ARABA/ÁLAVA;901;IRUÑA OKA/IRUÑA DE OCA;1;1;B;852;507;6;501;3;498;345;109;83;;;114;11;;12;1;1;61;3;4;;97;2
ARABA/ÁLAVA;901;IRUÑA OKA/IRUÑA DE OCA;1;2;U;649;365;3;362;10;352;284;85;78;;;45;11;;12;0;0;59;4;1;;54;3
ARABA/ÁLAVA;902;LANTARÓN;1;1;A;389;217;2;215;2;213;172;87;43;;;17;1;;8;0;0;21;5;1;;29;1
ARABA/ÁLAVA;902;LANTARÓN;1;1;B;348;207;0;207;0;207;141;58;55;;;27;1;;6;0;0;34;1;1;;23;1
ARABA/ÁLAVA;999;MUNICIPIO CERA ARABA;1;1;U;6181;362;2;360;0;360;5819;83;57;;;34;4;;20;2;4;69;3;1;;79;4
